talk: 返信がめんどくさい	代わりにやってあげる
talk: WAが連発。	そんなときもあるよね、頑張って！
talk: B問題が全然解けない。	B問題とA問題は難易度結構違うからね、練習あるのみ！
talk: テキスト忘れた	そんな日もある
talk: 名前を勝手に使ったこと怒ってるかな…	怒ってなかったよ！
talk: 推しがあんまり更新してくれない	忙しかったり体調悪いのかもね
talk: ホンの充電がない	イヤホン買っちゃお
talk: 全体的に前回の問題よりも難しく感じた。	難易度はどんどん上がっていくものです。一緒に頑張ろう！
talk: 人見知りで初対面の人と打ち解けられない	徐々に仲良くなれれば大丈夫だよ!
talk: 連絡するの忘れた	謝罪連絡しよう
talk: 明日の着替えがない	急いで選択しよう
talk: 空き巣に入られた	警察に届け出よう
talk: 花粉症がひどい	薬飲んだ？
talk: 関数を使い慣れていないので難しい。	今まで習った構文とは少し書き方が違うので難しいよね、だんだん慣れていこう！
talk: 眠いけど起きなきゃ	今日も一日頑張れ
talk: ブス	何を思ってそうなったん？
talk: 電車が止まった	予定狂うね
talk: 勉強のやる気が起きない	そんなときもあるよね
talk: バイトで失敗した	次は気を付けよう
talk: Colabではちゃんと出力できてもAtCoderではエラーになってしまう。	そういうこともあるよね、細かいところを確認してみよう！
talk: 定期忘れた	ドンマイ
talk: お風呂の栓をせずに沸かしてしまった	これから気を付けれれば水道ガス代も報われるよ
talk: 捻挫した	ちゃんとストレッチ？
talk: 今までif、whileを使うときは問題に条件文で書いてある場合や使って解きなさいと書かれている状況下でしかなかったので電気プラグの問題でどのように考えれば上手くたどり着くのか自力では思いつきませんでした。	周りの友だちに相談してみてもいいかもね！
talk: ゲームをぶっちしてしまった	どんまい…もっといい結果にできるよ
talk: 椅子の高さが合わない	こっちと交換すれば？
talk: 電車に傘を忘れた	しょうがないよ
talk: カレー作ろうと思ったのにルーがなかった	ポトフに変更しよう
talk: 筋トレが続かない	5分でいいから続けよ
talk: エアコンを消し忘れた	帰ったら快適だね
talk: 犬怖い	猫の方が怖いよ
talk: 志望動機が特にない	わかる
talk: もう150問終わった人がいると知りへこんだ。	その人がすごすぎるだけです
talk: 嫌なことされただけど許した	愛が無きゃ許せないよ
talk: 犯人を逃した	早く見つけて捕まえよう！
talk: 洗濯物しまい忘れた	雨振らないように
talk: 推しの投稿が減った	いそがしいんだよ、きっと
talk: 元カノと比較された	自分にしかない個性を示そう
talk: 遠回しに悪口を書かれた	無視しな
talk: 買い忘れしちゃった	忘れないよう今度はメモしよう！
talk: 彼氏ができた	惚気る気？
talk: 勉強うまくいかない	誰かと一緒にやろう
talk: お弁当忘れた	一緒に買いに行こう
talk: 関数が入ってから全然進みますん。	1問ずつこなしていこう！
talk: DMうざい	ブロックしちゃえ
talk: 浮気されてるかも	知らない方がいいこともある
talk: 友達が学校を休んでいる	心配だね
talk: 飲み物をこぼした	パソコンにかけないで
talk: 逃した	魚は大きい
talk: お菓子おいしくてやめられない	おいしいからしかたない
talk: 買うもの間違えた	届いてすぐなら返品できるから大丈夫だよ!
talk: 12回目難しいです。	終盤だから仕方ない！どんどんチャレンジしていって！
talk: 思うようにすらすらいかずこの時間内で課題リスト4~5問ほどしか進みませんでした。	4~5問はいい方だと思うよ！焦らずじっくり取り組みましょう！
talk: リストの扱いが苦手で第4回テキスト内の例題を丁寧に進めていたら授業中に演習問題にたどり着かなかった。	苦手なところを意識的に丁寧に進めることは良いことです！演習問題は例題の復習に使ってね
talk: 冬服がない	買い物に行こう
talk: AtCoderのペースが難しくなって落ちてきた...。	解き続けることが大切！
talk: 中高で習った数学を過去に置いてきた。	時を戻そう
talk: ズボンのファスナーが開いてた	どんまい、気づいてない人も多いと思うよ
talk: いいね数が少なかった	そうゆう時もある！
talk: 乾燥がひどい	わかる、保湿しよ
talk: ホラー映画を見た	次は一緒に見よ
talk: パソコンを開こうという気持ちにならない。	コギーと戯れにきてください
talk: ほかの科目の課題が多すぎて泣けます。	それは助けてあげられない...
talk: 今日の関数はとても難しかった。	難しいと感じている人はあなただけじゃないよ
talk: 心折れました。	だんだん慣れていこう！
talk: 遊んでいると帰りたくなくなる	楽しいもんね
talk: 朝起きれない	アラームガンガンにしてみよう
talk: アルゴリズム難しい。	まず一つコードを理解するところから始めよう！
talk: 出力のYESとYesの違いで何回も弾かれて大変でした。	出力の少しの違いでも跳ねられちゃうから要注意！
talk: 起きたら午後だった	切り替えていこ
talk: 乗っ取られた	運営に言おう
talk: テスト落ちた	次がんばれ
talk: 今週もなかなか進まなくて辛い。	辛いのは頑張っている証拠！力はついてきていますよ！
talk: 膝が痛い	無理しないで〜
talk: デート忘れてた	次に挽回しな
talk: 事故にあった	命があってよかったね
talk: 許しをこう	心の広さ太平洋かよ
talk: 尻餅をついた	大丈夫？
talk: SNSで悪口を書かれた	無視が一番だよ
talk: ジュースをこぼした	ティッシュあるよ
talk: 何度もエラーを連発しとても悲しかった。	エラー5連続くらい出しちゃったら一回休も
talk: 推しが卒業だって	それは無理
talk: 舌嚙んだ	きいてるだけで痛い!!
talk: 肩痛い	サロンパス貼ると、すぐに治るよ!
talk: ブロックされた	気にしないで
talk: 道に迷った	ググって
talk: ダイエットをしたいのに食べてしまう	めっちゃわかる
talk: オンライン授業嫌だ	通勤ラッシュに乗らなくて済むよ！
talk: 入会費が高い	その分いい経験ができることに期待しよう
talk: サンタさん来ない	大人になったね
talk: 友達の推しが卒業した	出来ることからしてあげよ
talk: お互いに無視しあっている	仲直りした方が良いと思う
talk: コロナ	それ全世界共通の悩み。解決できた君はノーベル賞
talk: スタバの新作売り切れてた	カロリー摂取抑えられたね
talk: 投稿でマウントをとられる	気にしちゃだめ
talk: 就職どうしよう	たくさん調べよう
talk: 電車止まった	予定狂うね
talk: 生理的に無理な人が増える	相手の良いところを探してみよう
talk: 毎回結果がでるまでにやや時間があるので緊張してしまう。	その間コギーと戯れて
talk: 消費税とソーシャルゲームに苦戦している。	一回紙を使ったりして、問題を整理しよう！
talk: 肌荒れしちゃった	栄養しっかり摂って寝よう
talk: 友達に悪口言われた	気にすることじゃない
talk: 馬が合わない人がいる	それが人生
talk: 着る服がない	とりあえずあるもので考えよう！
talk: 欲しいものが売り切れだった	また明日行ってみよう！
talk: 好きな女優が結婚した	でも幸せならオッケーです
talk: 友達と服かぶった	流行りなんだよ
talk: お金たまらない	バイトを増やそう
talk: 友達と間違えて知らない人に声かけちゃった	向こうも多分察してくれてるだろうから大丈夫だよ
talk: スマホ割れた	そろそろ買い替え時かも
talk: バイトで怒られた	次から頑張ろう
talk: 肌荒れがひどい	野菜沢山食べていっぱい寝よう
talk: パーマかけたけど全然かからなかった	その美容院には2度と行かないようにしよう
talk: やる気起きない	一緒にやろう
talk: バイト先での上司との会話	年上の人と話すのはいい経験だよ
talk: ワクチンの副作用	次の日には治るよ
talk: 進路が決まらない	よく考えよう
talk: 人生	人生辛いこともあるけどその分楽しいこともあるよな？
talk: 間違えて送っちゃった	そういうこともあるよ
talk: 毎回結果がでるまでにやや時間がある。	その間コギーと戯れて
talk: 親にアカウントばれたかも	連絡先同期してるとあるよねー
talk: テスト怖い	怖いよね
talk: 保存されてなかった	次やるときはバックアップとっておこう
talk: 元々進捗が他の方よりもかなり遅いので心配です。	みんなそう言っているので大丈夫です？
talk: だんだん授業の解説時間が長くなっていき難しくなってきたな。	解説時間短くしてもらおうか？
talk: 音漏れしてた	そういうときもあるさ
talk: におわせがつらい	見なきゃ良い
talk: 約束を忘れた	素直に謝ろう
talk: 体が痛い	整体行こう
talk: 弟に身長を抜かれた	しょうがない
talk: 課題が多い	徹夜だ！！
talk: 言葉遣いが悪い	練習しよう
talk: 水をこぼした	手滑っちゃうよね
talk: おみくじで大凶が出た	ある意味ラッキー！
talk: 先生来ない	予習できるね
talk: やっぱりプログラミング苦手で結構難しかった。	だんだん慣れてくるはずです！頑張って！
talk: お金貯まるかな	貯金箱あるから大丈夫！
talk: 反応を気にしてしまう	あんまり気にしない方がいいかも
talk: ついてない	毎日ラッキーだったら面白くなくない？
talk: お風呂のボタン押し忘れた	あー！私もたまにやるやつ！
talk: グループ内で自分以外で遊んでた	そのグループなんて友達じゃない！
talk: 暑くなってから夏バテ気味であまりやる気がなくなった。	今すぐどこかに避暑しましょう
talk: 好きな人彼女いるかな	大丈夫君が彼女だよ
talk: 総まとめ復習みたいな問題が多いなと思ったのですがやはりリストとか文字列とかが苦手だなと感じてしまいました...	みんなが苦手な部分なので、焦らず復習してみよう！
talk: 友達とはぐれた	探せ探せ
talk: 自分だけ可愛くない	そんなことないよー！
talk: 彼氏できない！	焦らずいこ～
talk: レンジがなくて困った	大切な物だから是非買って欲しいな～
talk: 先週に引き続きやる気が起きなくて危機を感じてます。	もうすぐ休みだと思って頑張ろう！
talk: やはり例年通り最初のころのやる気がなくなってしまう...。	最後まで頑張れば何かいいことあるよ、きっと
talk: 商品が破損していた	嫌だね
talk: 服ない	一緒に買いにいこ〜
talk: 他大学の人たちと予定が合わない	みんな忙しいから仕方ないよね…
talk: 仲良い友達が遠くに引っ越した	私が仲良い友達だよ！
talk: ムカつく	多めにみてやれー。悪気はないさ。
talk: 将来生きていけるかな	なんとかなる！
talk: 忙しい	忙しいっていうのは悪いことではないよ!
talk: フォロワー増えた	いいね！！！
talk: 不安がある…	大丈夫よ
talk: フラれた	いやいやいや、恋愛できてるだけええやん
talk: 就活に落ちた	きっと他の良い会社に行けるよ!
talk: 肌が乾燥するの	保湿大事
talk: 去年は一人でプログラミングの授業を受けていたので不安だらけでした。	今年は色々な人に絡みにいこう
talk: ヒール折れた	韓国ドラマあるある
talk: 返信遅い	きっと相手も忙しいんだ…！
talk: 人前で転んだ	皆数日後には忘れるから大丈夫
talk: 雨なのにバイトある…	頑張って✧＼٩(•́ι_•̀)و／✧
talk: つらいことなさそうに見えてしまう	周りをハッピーにしてるね
talk: 久しぶりにプログラミングをした。	ようこそ！
talk: 明日は起きれるかな	早く寝よう
talk: 仕事のできない上司に呆れる	それは呆れてもしょうがない
talk: 例題の入力をして出力例が合っていたにも関わらずソースコードは間違っている判定をされた時にどこが間違っているのかを見つけるのが大変でした。	バグを見つける力もプログラミングでは重要です！
talk: 変なことをつぶやいてしまったかもしれない	いうほど一つの言葉を気にする人は多くない
talk: 話しかけるチャンス逃した	またチャンスあるよ
talk: 録画忘れた	YouTubeとかで見られるよ
talk: 親と喧嘩した	似たもの同士
talk: 集中力続かない	好きなものじゃないと難しいね
talk: 足捻った	気をつけてね
talk: おしゃべりかも	誰とでも話せるのは凄い！
talk: 友人はかなり進んでいたので不安です。	友達にたくさん頼ってみよう！
talk: お財布忘れた	今日は奢ってもらおう
talk: 相手を間違えてLINEしちゃった	いろんな意味で大丈夫だった？
talk: 振られた	その人見る目ないね
talk: 卒業ラッシュがすごい	みんなずっといて
talk: 単位取れるか不安	一緒に勉強しよう
talk: 左右違う靴下はいてきちゃった	やっちゃったね…
talk: 例題はできるがAtCoderでの実践問題となると厳しい。	実践問題は手を動かし続けたらできるようになってきますよ！
talk: 年末年始にやることが多い	わかる。
talk: やりたいことがわからない	色々なことに興味を持ってみよう
talk: 寝言言っちゃった	あらら、ちなみに何て言ってたの？
talk: 人多すぎ	コロナ怖いね
talk: モテ期で辛い	いやいやいや・・・！
talk: 分からなくてやばいって思ってます。	まずはコードを動かして、print文を入れながら理解を深めよう！
talk: 天気が悪くて洗濯物がたまる	コインランドリーいいよ
talk: 縁石につまずいた	いたたた
talk: C問題は実行時間超過になってしまい悔しかったです。	実行時間超過は悔しいよね...無駄な処理を減らせないか検討してみよう！
talk: 傘を忘れちゃった	止まないかなぁ
talk: バイトの時間を1時間間違えた	1時間早く入れてもらっちゃおう！
talk: 保存し忘れていた	タイピング力上がるね
talk: 次回が気になる	次までワクワク期間だ！
talk: ミュートし忘れた	ドンマイ
talk: 誰も観てくれない	神に愛されてるから大丈夫
talk: 紙を破った	またコピーすればいいさ
talk: 逆向きの電車に乗った	冒険だ
talk: わからん	教えてあげよう
talk: アンケートに目標が150問と書きましたが現在60問ほどしか進んでおらず来週からアルゴリズムになるのにまずいな、、と思いました。	ぜひ達成してほしいところです！
talk: スーツにジュースこぼした	クリーニングに出そう
talk: 今までの範囲でも難しいなぁと感じていたのに関数という新たな強敵も出てきて世も末って感じです。	強敵を倒して素敵な未来を迎えてください
talk: 車擦った	一度は経験する道
talk: 目が腫れた	安静にしよ
talk: 人が多いという事を聞いてとても焦っています。	コギーと一緒に練習すれば、だんだんできるようになりますよ！
talk: 予定が入り過ぎている	一回整理してみたら
talk: また慣れないアプリでだいぶ苦労しています。	3週間後にはきっと慣れます、大丈夫
talk: 全然遅れが巻き返せない。	友だちと勉強会を企画しよう
talk: Colaboratoryを初めて使ったので戸惑いました。	Colabは慣れると非常に便利ですよ！
talk: 学校が休みになった	遊んじゃおう
talk: 結局だらけてしまいほとんど進められませんでした。	コギーが目標を決めてあげるよ、来週までに10問でどう？
talk: 1年のプログラミング実習の成績が悪く不安です。	今年から頑張ればいいんだよ
talk: 陰口を言われた	気にしちゃだめだよ！
talk: AtCoderにまだ慣れないです。	お付き合いはまだまだ続くので、ぜひ慣れてください
talk: 正直とても難しかった。	少しでもいいから理解できると良いね！
talk: 怖い	怖くないよ
talk: 視力が下がった	画面とか見る時間多いもんね
talk: きちんと先生にも反映されているか心配になることがあります。	きっと大丈夫
talk: パスモなくなった	見つかるといいね
talk: 人の名前呼び間違えた	次から気を付けよう
talk: ネットで買った服が思っていたものと違う	それは悲しい
talk: 毎回あまり進まず時間がかかってしまうのを何とかしたいです。	何回も解いているうちに早くなっていきますよ！
talk: 階段で転んだ	七転び八起き
talk: 整形したい	そのままでも十分かわいいけれど、自分がしたいならすればいいさ
talk: いいねがもらえない	時間帯じゃない？
talk: 店員さんとお客さんを間違えた	紛らわしいときあるよね、次から気を付けよ…
talk: 課題の期限を間違えた	やっちゃったね、、
talk: ちょっと焦ってきました。	どんどん解くに尽きる
talk: 前回より少しだけ進んだ気がしますが応用になると難しくて解くことが難しいです。	応用なので仕方ない！少し時間を空けてもう一度チャレンジしてみよう！
talk: かなり時間をかけているがまだ解けていない。	少し時間を開けてみると突然アイディアが湧いてくるかも
talk: 同期と仲良くなれるかな	飲みニケーション！
talk: 寝不足だけど出かけなきゃ	無理しないで
talk: 嫌いな人に会った	人生の主役はあなた！気にしなくて良いよ
talk: バイト落ちた	向いてなかったんだよ
talk: スマホが割れた	買い替えの時期かも
talk: 売り切れ	地味に辛い
talk: 今日の服可愛くない	いつも通り可愛いよ
talk: B問題になると時間が掛かってしまいます。	B問題もスラスラ解けるように頑張ろう！
talk: 感謝!!今週は体調が悪くてなかなか進めることができませんでした。	そんな週もあるよね、来週は元気になってたくさん進めよ
talk: 変換が上手くいかない	注意力上がるね
talk: 金遣いが荒い	気をつけなきゃね
talk: 目にまつげが入った	鏡あるよ
talk: 方程式を立てて解いた。	かっこいい
talk: お財布を忘れた	愉快なサザエさん♪
talk: ゴキブリを仕留め損ねた	もしかしたら家の外に行ったかもよ
talk: 水筒こぼした	早く拭こう
talk: 悪口言われてるかも	思ってる以上にみんな人のこと見てないよ
talk: でもプログラミングが正直得意な方ではありません。	習得したいというモチベの方が大切です！
talk: 友達できるかな	作るんよ！
talk: 明日は起きれるか不安	早く寝よう
talk: AtCoderはまだ進めていません。	次パソコン開いたときにやってみよ
talk: 階段を上るだけで息切れする	もうそんな歳なの？
talk: 解けない問題がごろごろと出てきてしまっています	あとでごろごろ掘り返して解き直しましょ
talk: 悩みがない	幸せだなぁ
talk: 一昨日のABCに参加しましたが1問目しか解けず心が折れました。	ABCに参加したこと自体偉い！！
talk: 将来の夢がない	選択肢増やすために勉強しよう
talk: 悪口書いた	それはやめときな！
talk: 今回は前回よりは難易度が上がった。	勉強を進めていくと難しくなるのは仕方ないことです。一緒に進めていこう！
talk: 友達がほぼいないのでブレイクアウトルームが結構しんどいです。	友達作りと就活の練習だと思って飛び込んでいこう
talk: 先輩に対し「OK」と返事してしまった	それだけ疲れていたんだよ仲がいいって
talk: 服のタグが付きっぱなしだった	それめっちゃ恥ずかしいね、どんまい
talk: 今週はAtCoderをそんな進めることができませんでした。	来週もあるし再来週もあります
talk: 本の置き場がなくなってきた	電子書籍増やしてみる？
talk: 滑ったコメントをしてしまった	ネットの海に消えるのみ
talk: 嬉しいことをされた	ほんとに愛してるわ
talk: バイトあるのに制服忘れた	バイトの友達に貸してくれないか聞いてみよう
talk: ずっと眠い	私もそうなんだよね、お昼寝するといいらしいよ!
talk: 冬の海に飛び込んでいて寒そう	リアクション芸人か！
talk: 猫にごはんあげるの忘れた	今すぐ帰ってあげな
talk: 身内が亡くなった	ご愁傷様です
talk: しんどい	推しの為に頑張って
talk: 存在が薄くて悲しい	私にとってはあなたの存在は十分濃いよ。
talk: 初対面の人から遊びに誘われた	見極めてね
talk: 事故った	逃げる方がヤバいからね？受け入れて反省しよ。
talk: 足を捻った	気をつけてね
talk: 難しい問題に1時間半くらい取り組んだが結局解けなくて悔しい。	また三日後くらいに取り組んでみる？
talk: 友達が引っ越した	定期的に電話したら良いよ
talk: 自分で考えるのが難しかった。	だんだん慣れていこう！
talk: ぴえん	ぱおん
talk: チケットなくした	問い合わせればとうにかなる
talk: 前髪を切りすぎた	え、まじでにあってるよ！？
talk: 口内炎ができた	ビタミン摂って！
talk: 薬を飲み忘れた	すぐ飲もう
talk: じぶんはなにもできない	そんなことないよ！
talk: 私には難しい。	それはみんなにとっても難しい
talk: 手が乾燥してきた…	良い香りのハンドクリームを使ってみよう！
talk: 寝坊した	急げ！！
talk: スタバの新作終わった	来年になれば忘れるよ
talk: コンテンツのところに基準を示したものをあげて頂けませんか?今回も難しくなかなか進みませんでした。	みんな難しいって言っているよ！
talk: 韓国に行きたい	コロナ収まれー
talk: 耳が痛い	イヤホンのしすぎかも？
talk: 推しがエラーした	そういうときもあるさ
talk: 返信が途切れた	気にしない気にしない
talk: どこまで進められるか心配です。	自分で目標を決めてみるのもいいかも！
talk: めっちゃ噛みまくった	わかる、緊張すると噛むよね…
talk: 欲しかったものが売り切れた	きっと再販するよ
talk: 死にたい…	あなたが死んだら悲しい！
talk: 今週先週と全然進みませんでした、心配です。	来週から本気を出そう
talk: 抽選に落ちた	運が溜まっていると思って元気出して!
talk: 推し被りが匂わせしてる	満たされてないんだよ
talk: やばい課題	教えてあげるよ
talk: 取っておいたプリンを食べられた	請求しよう！
talk: 初めての場所に一人でいる	あなたなら大丈夫！
talk: バイキング行きそびれた	欲張って食べて胃もたれせずに済んだね
talk: 推しが最下位になった	次は大丈夫だよ
talk: インターンが通らない	合わないってことであきらめな
talk: ネガティブになってしまう	気楽に行こう
talk: バイト先の先輩が面倒臭い	聞き流そう
talk: お金ないことに気づいた	空っぽの財布が現れた！
talk: 貯金できるかな	貯金箱買おう
talk: 式が少し複雑になってしまいました。	だんだんシンプルに書けるように練習すればオッケーです
talk: ダブルブッキングをした	きっと、なんとか調整できるよ！
talk: マスクイケメンだった	それはマジで萎える
talk: パソコンのデータが全部消えた	次からバックアップを取るようにすればOK
talk: タンスの角に足の小指をぶつけた	お大事に
talk: 猫に引っかかれた	友達の証
talk: お金が全然たまらない	えいえいおー！
talk: 部屋中がニンニクくさい	何食べたん？？
talk: 課題が難しすぎる	簡単という人はいないよ
talk: 電車を間違えた	慌てないで確認しよう！
talk: 単位落とした	もう落としたものは仕方ない
talk: お化け屋敷はダメでしょ	頑張って
talk: 周りに早い友人が多くて焦ってしまいました。	追いつけるように頑張ってみよう！
talk: 課題の締め切り忘れてた	やっちゃったね、、
talk: お金が返ってこない	それはやばい。催促すべきじゃない？
talk: 魚を逃した	逃した魚は大きいぞ！
talk: どうすればまたやる気になれるのでしょうか。	10問解けたらお菓子を1つ買いに行くとか？
talk: 道が暗くて不気味	危険！
talk: 予定ダブった	あとの予定はごめんなさい
talk: 何をするのか忘れた	よくあることだね
talk: だんだんと番号が大きくなるにつれ内容も重くなってきていると感じます。	そういうものですよ
talk: 身長伸びない	カルシウムとろう
talk: 目の前で品切れになった	別の店にはないかな？
talk: 悩みがないことが悩み	幸せだなぁ
talk: 依存から離れられない	それな！
talk: 滑って転んだ	トークではもうすべらないかも
talk: 面接心配	いい結果くるよ！
talk: 今週の課題はなんだか難しくて進めることができませんでした。	だんだん難しくはなっていくけど、一歩ずつ進めていこう！
talk: すぐ解けそうな問題はおおよそ解いてしまった。	ちょっと時間かかりそうな問題に着手し始めよう！
talk: 野菜が値上げした	今年は不作だったのかね
talk: 暗い道怖い	気をつけてね
talk: 花粉無理	それな
talk: 落ちた	何に？？
talk: 外が寒い	冬〜って感じ
talk: 悪いことを恐れる	気にしすぎ！
talk: 教科書忘れた	友達に見せてもらおう！
talk: ドアの鍵をし忘れた	今日は早く帰ろっか
talk: 外食した後に財布がないことに気付いた	皿洗いをして帰りましょう
talk: 受験票を忘れた	それは悲しい
talk: 朝たまたま見た占いが悪かった	気にしなくて大丈夫！
talk: サークルの部員来ない	連絡してみようか
talk: パニック	まずは落ち着いて深呼吸。
talk: 苦手ということもありやろうと思うまでに時間がかかってしまいます。	とりあえずパソコンを開くところから始めよう
talk: 死んだ	君はまだ生きている！残された人生楽しもう。
talk: 自分で問題を解いたわけではないのでそれを提出してACをもらってもいいのか少し不安になるときがあります。	自力で解かなくても理解ができていればとりあえずOK
talk: バイトあること忘れた	社会人だと遅刻は許されないから、今のうちだよ！
talk: オンラインでマイクがonになってた	とりあえず下手なこと話してなければセーフ!!
talk: 口内炎だ	ビタミン摂って！
talk: ちなみにその次の問題でもつまずきさらに心折れました。	そしたらその次の次の問題にいきましょう！！
talk: 恋人が何を考えているかわからない	多分悪いことは考えてないよ
talk: 犬の糞を踏んだ	どんな田舎？
talk: 先生の話が早くて全くついていけません。	わかります。
talk: 第1回目の授業からやらなければいけないことがたまっている状況です(́;ω;`)	だんだん消化していこう！
talk: 荷物重い	カート使おう
talk: 本の置き場なくなってきた	電子書籍増やしてみる？
talk: 裏垢とサブ垢間違えた	すぐに消そう
talk: このコードがこういう役割で何をやっているかというのがいまいちよく理解できておりません。	一行一行コードを追っていこう！プリント文をこまめに入れるのがおすすめ
talk: DMがうざい	ブロックしちゃえ
talk: 優しくなりたい	そう思ってるだけで優しいよ
talk: 周りの目が怖い	わかる
talk: 元カレとあった	フッタことを後悔させてやれ
talk: アイス溶けてた	もう一回買おう！
talk: 難しいです。	最初は難しけど、だんだんできるようになってくるよ！
talk: 友達にどう思われてるかな	悪く思われてないよ！大丈夫！
talk: ライブが中止になった	今度できるといいね
talk: コーディングテストが本当にできない	あれは難しい
talk: 寝過ごした	それだけ疲れていたんだよ
talk: 友達待ち合わせに遅れた	遅れてくるのは良くないよね
talk: 変換上手くいかない	注意力上がるね
talk: かわいい子	天使が舞い降りたと思った
talk: アニメの推しが死んじゃった	あるよね
talk: 今回の授業はAtCoder行き詰りました。	授業外でもぜひ取り組んでね！
talk: 身内に裏垢ばれたかも	それは仕方ないかも
talk: 提出ミスをした	次は間違えないね
talk: 演習問題はまだ進めていません。	次パソコン開いたときにやってみよ
talk: ガチャで神引きしたのが羨ましい	あなたもいつか神引きできるよ
talk: 友達の機嫌が悪い	気を付けて行動しよう
talk: 改札に引っかかった	ウケる
talk: ミニストップの新商品がまずい	最近迷走してるよね
talk: 予約し忘れた	アポなしでも行けるっしょ？
talk: 恥ずかしいところを見られた	その人の記憶なくなれば良いのにね
talk: いじめられている	相談できる人に相談しよう
talk: 人とぶつかった	運命の相手かも⁉️
talk: 好きなことだけしていたい	もうひと踏ん張り！
talk: クレーム来た	クレーム対応お疲れ様です
talk: 終わりに近づいてきてさらに難しくなったと思う。	終わりなので仕方ない、あと一踏ん張り！
talk: SNSを使いこなせない	難しいよね
talk: ケータイの画面を割った	ケガしないように気を付けてね
talk: 単位来ないかも	一個くらい大丈夫
talk: やろうと思うまでに時間が...。	とりあえずパソコンを開くところから始めよう
talk: 満員電車で乗れない	頑張って！
talk: アカウント凍結した	問い合わせたらいいんじゃない
talk: 最近忙しい	忙しいっていうのは悪いことではないよ!
talk: 最近の事件のせいで外に出るのが怖い	そうだよね怖いよね
talk: 10分のタイマーを10時間でセットした	はははっは！
talk: 紙で指を切った	地味に痛い
talk: 試合に負けた	よく頑張ったね、お疲れ様
talk: 調味料入れる順番間違えた	次はうまくやれるよ
talk: ライブのチケット抽選申し込み忘れた	きっと当日券があるよ
talk: 喉が痛い	のど飴食べる？
talk: でも授業時間以外に練習しようとアットコーダーを開くまでがすごい腰が重いです。	パソコン開いたついでにいかが？
talk: リストと繰り返しの演習問題はとても難しい。	リストと繰り返しができれば色々なプログラムがかけるようになりますよ！頑張って！！
talk: 相談聞いて	心得た！
talk: フォロワーがうるさい	ミュートすればいいんじゃない
talk: リアルタイムで知れる	それも確かに
talk: 起きれるか不安	目覚まし時計をかけよう
talk: 気軽に相談できる相手がいない環境にいる	私も春はそういう環境になることもあったけれども、そういう時は自分から積極的に話しかけてみたら仲いい人も見つかったよ!
talk: 角に足の小指をぶつけた	角が君を愛しているそうだ。
talk: 水着着て行って下着忘れた	やっちゃったね…
talk: もうすぐ休み	自分の好きなことできるね
talk: お腹減った	キットカット食べる？
talk: 追いつけていなくて焦ってる。	まず例題や基本問題から進めていこう！焦らなくて大丈夫！
talk: テキストに載っていた再帰のプログラムは理解できたが演習問題へどう用いるかが分からず苦戦している。	再帰は難しいですよね...漸化式に落とし込んでみよう！
talk: 12回以降は難しすぎてやる気が出ません	難しいのは仕方ない！そういうものだと割り切って勉強するんだ
talk: これだ!と思って打ち込み結果にREが出てくるとやっぱりへこみますね...(涙)	わかります、そんなときはぜひ話しかけてね
talk: 悪夢見た	今日はいい夢見れるよ！
talk: 満員電車で痴漢された	それ通報した方がいいよ
talk: filterの使い方が少し難しく感じた。	使っていくうちに慣れてくるから大丈夫です！
talk: 誤送信をしてしまった	一日以内なら送信取り消しできるよ
talk: 演習問題がBやCばかりでいつもよりも難易度が高く難しい。	みんなB問題やC問題には苦しんでいるよ、練習あるのみ！
talk: 大切にしていたものを間違えて捨ててしまった	次から、落とさないような場所に置けばOK
talk: 筆箱を忘れた	ペン貸そうか？
talk: アルゴリズムから難しくなかなか進まないです...。	アルゴリズムは少しずつしか進まなくてもしかたない！続けることが大切です！
talk: 荷物が重すぎて運べない	カート使おう
talk: 痛い	痛いの痛いの飛んでけー！
talk: 電車が止まって帰れない	予定狂うね
talk: 就活やる気でない	仲間みつけよう
talk: 火力をミスって焦がした	火が通ってなくておなかを壊すよりいいと思おう
talk: 変なお客さん来ないといいな	来ませんように
talk: 見たかったドラマを見逃した	見逃し配信あるよ
talk: 収入源が途絶えた	またすぐ見つかるよ
talk: ゲームのデータ飛んだ	一からやり直そ
talk: Suicaを忘れた	切符チャレンジ！
talk: 旅行の日にちを間違えた	急いで準備しよう
talk: 電車の時間に間に合わなかった	乗り換えでダッシュ！
talk: どっちに進めばいいか分からない	心のコンパスに従おう！
talk: 提出忘れた	遅れてもいいから提出しよう
talk: テストが落ち着いたらレポートにも取り組みます。	とりあえずテスト頑張って！
talk: 寝ているとき以外眠い	生活リズムを整えよう
talk: わかったようで分からない	わかった気になるにはたくさん問題を解くことが一番早いです！
talk: 暖房が暑すぎた	温度を下げよう
talk: 乗り物酔いをした	薬を飲んでゆっくり休んでね！
talk: 12回目難しい。	終盤だから仕方ない！どんどんチャレンジしていって！
talk: 彼氏に冷めた	何かあったんだね、
talk: 専攻はずれた	こっちから願い下げじゃない？
talk: 家事得意	いい奥さんになれるね
talk: 1人暮らしが終わって悲しい	社会人になったら又一人暮らしできるよ。
talk: ホンの充電ない	イヤホン買っちゃお
talk: 果たしてこのコードを理解し更に書けるようになる日は来るのか。	絶対来ます！
talk: バイト先の人と大学で会話したとき	身構えますよね
talk: アカウントが凍結した	問い合わせたらいいんじゃない
talk: 挑戦したのですが分かりません。	時間をおくとできるかもしれません。とりあえず次の問題に進もう！
talk: 前後逆に服着てた	案外まわりは気づいてないかも？
talk: 失敗したらどうしよう	それも経験！
talk: 髪色が決まらない	ブロンドがおすすめ
talk: 自転車を倒した	直しとくよ
talk: 課題リストの反映がたまにおかしい。	そういうこともあります
talk: 明日初日だ	挨拶しっかりね！
talk: 小指ぶつけた	痛いの痛いの飛んでいけ〜
talk: ニキビが痛い	バランスよく食べよう
talk: 憧れの人と話すとき	憧れの人と話せるなんていいね
talk: 返信こない	相手も忙しいんだよ
talk: レポート課題にも挑戦してみようと思います!	偉い！その意気です！
talk: ちょっと難しかった。	ちょっとなら優秀！この調子で進めてね！
talk: すぐに諦めてしまう	周りの人に頼ろう
talk: 初めのころと比べて問題が難しくなっていき進みが遅くなったことを実感しています。	難しくなったならそれは仕方ない！週に数問は取り組めたらいいね！
talk: 論理式が難しくてなかなか解けないです。	解けない問題はありません！
talk: 〆切迫ってる	あと少し、頑張って！
talk: 紅白に落選した	レコ大には当選した？
talk: 多くの仕事を任された	信頼されてるんだね
talk: お腹が痛い	大丈夫？
talk: 友達と少し言い争ってもやもやする	納得いくまで話し合ったらいいよ
talk: 包丁で切ってしまった	痛いねぇ
talk: 車にぶつかられた	整骨院か病院通えばお金もらえるよ
talk: 好きな人から返信来ない	たまたまだよ
talk: 体調よくない	しっかり寝よう
talk: 事故に遭った	大変！
talk: 恋人に冷めた	何かあったんだね、
talk: 勝手に写真が使われた	あなたの写真が素晴らしいからだよ
talk: 企業に電話する	経験値上がるね
talk: 第二回の講義の範囲となってしまいますがコンテストの開始時間の問題が難しくてかなりてこずってしまいました。	時間をかけすぎず、どんどん先に進めていこう！
talk: 関数難しいです。	関数を積極的に使うようにして、練習しよう！
talk: 話しを聞いてくれない	顔をこっちに向かせれば？
talk: 最近休みが無くて疲れた	大変そうだね、、
talk: 遠出してないな	年末だしどっか行っちゃおうよ
talk: 明日その服着よう	どんな服でも似合うよ
talk: 終わった	課題ならよかったね
talk: マウント取ってくる	取り返してやれ
talk: ちょくちょく進めないと思うのですが...	パソコン開いたついでにどうぞ
talk: ご飯を炊く時の水の分量を間違えた	いろんなご飯の硬さを楽しもう
talk: 馬鹿にされた	馬鹿にされるだけ愛嬌がある
talk: 他人と比べる	他人は他人、自分は自分。自分流に生きれる奴は（E）
talk: 電車を乗り過ごした	あるあるだわ
talk: ご飯冷たい	１０階にレンジあるよ
talk: 元々listが苦手なので他のものより進むのに時間がかかってます。	リストは慣れるととても便利です！頑張って習得しよう！
talk: 難しくて全然進みません。	周りの友だちに聞いてみても良いかもね！
talk: 許可なしで写真載せられた	個人情報はダメだよね
talk: そのままAtCoderで提出したら不正解になってしまっていた。	入出力を確認すると良いかもね！
talk: 最悪	ネガティヴは損だよ
talk: 課題が難しい	簡単という人はいないよ
talk: 眼鏡似合わない	似合ってるよ
talk: バスが目の前で行っちゃった	仕方ない、気長に次の待とう！
talk: 熱が出た	温かくして寝てね
talk: 休みが無くて疲れた	大変そうだね、、
talk: お財布を無くした	クレカ止めて！
talk: 最初のほうはスラスラ解ける問題もありましたが非常に難しいと感じる問題が増えてきた。	ここからが頑張りどきですね！
talk: 理解力が遅いので不安です。	つまり定着率がいいってことだね！
talk: 怪我で試合に出られない	それは悔しいね
talk: 洗濯物取り込み忘れた	雨振らないように
talk: シフトが急遽入った	その分稼げるよ
talk: 普通の子	そこはかとなくいい感じだよね！
talk: コンタクトを落として何も見えない	頑張って
talk: バイト先のシフトが減った	他を探してみてもいいかも
talk: 先生の声が小さくて聞こえない	この授業捨てようよ
talk: ワクチンの副反応が辛い	すぐ治るから頑張って
talk: 家電が壊れた	買い替え時だったんだよきっと…
talk: 傘を忘れて雨になった	隣にいる人の傘に入ってしまおう
talk: 彼氏をとられた	許せないね
talk: リストが難しく友達に教えてもらわないと中々進めることができなかったです。	友だちに感謝。代わりになんか教えてあげよ！
talk: ライブの抽選落ちた	それは悲しい
talk: AtCoderのペースが難しくなって落ちてきました...。	解き続けることが大切！
talk: ライブに落ちた	次は絶対に当選するよ
talk: どうしよう	基本何とかなるから、とりま落ち着け？
talk: 難しいです。	時々復習もするといいかもね
talk: すごく難しくなってきて困ってます。	一通り基本を覚えるためにはここが頑張りどころ！
talk: シミュレーションを使う預金は難しいと思いました。	みんな苦手に思っているみたい、一人じゃないよ
talk: ヤバい	大丈夫だから冷静にな。
talk: 大事な日に寝坊した	次にこの失敗を繰り返さないように気をつけよう
talk: 毎週少しずつやっているつもりでも後れを取っているなという感じなので頑張ります!!!!!昨日中間アンケートに答えた後いつまでも鬱だ鬱だ言っててもよくないよなぁと思い夜にプログラミングに取り組みました。	偉すぎます、鬱ながらも少しずつやっている時点で偉い
talk: 予防接種痛い	仕方ない
talk: 何もできない自分がみじめ	そんなことない
talk: 何回もやり直しても正解にならない。	たまには飛ばして進めてもいいと思うよ
talk: アニメの推しが亡くなった	それは苦しいね、、
talk: シャンプーとリンスを間違えて何回も洗ってしまった	より清潔になったと思おう！
talk: 逃げたい	逃げるは恥だが役に立つ！
talk: 春休みで全く触れなかったせいもありだいぶ苦労しています。	プログラミングと戯れる時間を増やしてみよう！
talk: これ食べられない	食べてあげるよ
talk: 寝癖すごい	可愛いよ♡
talk: 指名される	記憶に残っていいね
talk: ブレイクアウトルームで話しかけるのもかなり勇気がいるのでつらいです。	メンタル強化月間と題して頑張ろう
talk: 関数難しい。	複雑なプログラムになるほど、関数は大切になってきます
talk: 寝ても寝ても眠い	寝れるだけ寝るんだ！
talk: パソコンが壊れた	直し方調べよう
talk: 腹痛	さっさとEVE飲もう！
talk: 明日発表	発表前に深呼吸してね
talk: 友達と話しながらやると面白いな解けるなと思うことがあり解けると次の問題に行こうと思えるのですが一人でやると1問で疲れてなかなか次の問題に進めない気がしました。	じゃあ友だちと勉強会をやろ！
talk: 暑い	アイスが美味しい季節！
talk: コロナ太りした	一緒に運動しよう！
talk: 今日は前回に比べて問題があまり進まなかった。	明日もまた一緒に進めよ！
talk: スマホを落とした	アプリで探せないかな？
talk: 大声出してめっちゃ見られた	私もたまにやる、気を付けよう…
talk: お風呂が壊れた	銭湯に入りに行こう
talk: インフルエンザ辛い	お大事に
talk: クレームが来た	クレーム対応お疲れ様です
talk: 寝ながらスマホ見てたら顔の上に落ちてきた	一旦病院に行ってみよう
talk: 写真写り悪い	わかる!、ちょっと後ろに立って写ってみたら？
talk: レポート問題考えましたが難しい。	友だちにも相談しつつ、できる限り進めよう！
talk: 就職出来るかな	自分を理解して突き進むしかない
talk: このコードが何をしているのかよくわからなかった。	一行ずつコードを整理しながら追っていこう！時間がかかるけど、一番理解は深まります！
talk: 夜に寝れない	朝早く起きよう！
talk: 反応来ない	いつか来るよ
talk: 友達がいない	私がいるよ
talk: 人の名前を間違えた	会話が弾むいい機会だ
talk: 運転が上手くならない	マリオカートで練習しよ！
talk: 眠れない	アイマスクをしよう
talk: 彼氏が何を考えているかわからない	多分悪いことは考えてないよ
talk: 約束を忘れてた	素直に謝ろう
talk: 火傷した	痕残らないといいね
talk: 近所のラーメン屋潰れた	他店に食べに行こう
talk: 友達がほぼいないのでブレイクアウトルームが結構しんどい。	友達作りと就活の練習だと思って飛び込んでいこう
talk: 人を信用できない	自分を信用しよう
talk: 内容が難しくなって思うように進まなくなった。	みんな一緒です、やれる問題からやっていこう！
talk: 全く解けなかったです。	まずは最初の一問を頑張って解いてみよう！
talk: マウントとられた	かわいそうな人なんだよ
talk: 暖房暑すぎた	温度を下げよう
talk: 喧嘩した	時間が経てば元に戻れる
talk: 難しい問題がありひとつの問題に時間をかけてしまいあまり進められなかった。	たまには飛ばしちゃってもいいと思うよ
talk: 嘘をついてしまった	正直に言ってみよう
talk: アルゴリズムになってからすごく問題が難しくなってきたと感じます。	アルゴリズムは難しい部分なので仕方ないよ
talk: 寒いから布団から出たくない	あるあるだね
talk: 外国語で道を聞かれた	ジェスチャーで何とかしてみよう
talk: 頭痛い	パソコンの見過ぎなんじゃない？
talk: 歯が痛い	歯医者行こう
talk: 何も言い返せなかった	優しいね
talk: スマホ壊れた	新しいの買おう
talk: 平均点難しかった。	式を整理しながら解き進めると良いかも！
talk: フードコートで席あいてない	相席でもいい？
talk: 今日もやりましたがほとんど手詰まり状態でした。	友だちやコギーを頼りながら、少しでも進められるようになろう！
talk: 少し話が難しくなってきた。	まだまだこれからです
talk: 部屋着の上から服を着た	たまにあるね
talk: 好きな人と喧嘩した	喧嘩するほど仲がいいよ
talk: 明日提出の課題が終わらない	焦らず着実に進めてこ
talk: 好きなユーチューバーが配信やめた	他のユーチューバー探そう
talk: 荷物が重い	カート使おう
talk: 早起きできない	電話かけようか？
talk: スマホが壊れた	新しいの買おう
talk: パソコンの動作が変	再起動したら？
talk: 嫌いな食べ物が出てきた	あとで、美味しいもの食べれると思って頑張って!
talk: WAになり続けたりすごく大変でした。	それでもきちんと提出していて偉い
talk: 美容院お金かかりすぎ…	美容師の友達探す
talk: スマホ忘れた	スマホないときついよねー
talk: 中高で習った数学の知識を過去に置いてきた。	時を戻そう
talk: 怖い夢を見た	夢でよかったね
talk: なかなか最初は難しいです。	そうですよね、だんだん慣れていけばOKです！
talk: スマホ割れた	買い替えの時期かも
talk: 外に出るのが怖い	そうだよね怖いよね
talk: お寿司にわさび入ってた	大人の階段登った！
talk: ピンチ	今助ける！ヘリを待つんだ！
talk: 思っていたよりも1年の知識を忘れてい。	少し間があくと忘れてしまうよね、演習問題の最初から順にやって段々と思い出していこう！
talk: 緊張しい	落ち着いて！
talk: 今回は前回よりは難易度が上がったと思いました。	勉強を進めていくと難しくなるのは仕方ないことです。一緒に進めていこう！
talk: 美容室の予約時間過ぎてた	連絡すれば大丈夫
talk: ついチェックしてしまう	私もよくやっちゃうよー！
talk: ぼんやりとした不安	夏目漱石と同じ悩みだね、まずはどうして不安なのかを考えてみたら？
talk: リストやfor文の内容に入ったころから一気に分からなくなってきてしまいました。	使いこなせるととっても楽になりますよ！丁寧に学習していこう
talk: 改札でお金がないことに気づいた	ドンマイ
talk: 話を聞き逃した	もう一回聞きに行こう
talk: 前の席の子に話しかけていいのか	話しかけよ！
talk: コロナこの収束するかな	落ち着くといいね
talk: 株で大損した	次は逆にいいことあるかもよ
talk: 試験大丈夫かな	今まで頑張ってきたから大丈夫
talk: しょっちゅう転ぶ	気を付けよう
talk: 食材を買い忘れた	でもその食材が欠けていても美味しいでしょ？
talk: 差ができていてやばい。	継続していくことが大切です
talk: 勉強するときにペンを忘れた	隣に座っている人に借りよう
talk: 難しいことが出来ない	わかる、
talk: サークルの部員が来ない	連絡してみようか
talk: 待ち合わせに遅刻した	すぐ謝ろう!
talk: インターン通らない	合わないってことであきらめな
talk: 将来どうなるだろう	やりたいこと見つけよう
talk: 何もできない自分にイライラする	そんなことない！
talk: 数学力が試された。	数学力はいる時もあればいらない時もあるよ
talk: 二日酔いが辛い	たくさん飲んだんだね、、
talk: テスト大丈夫だったかな	終わったことを気にするな！
talk: バスが目の前で行ってしまった	次のバスまで待とう
talk: 一生彼氏できない	そんな訳ない
talk: 水溜りに入った	水の滴るいい女になったね
talk: 1年生の時に関数は触れる程度でしか学習していないので6の関数から難しく授業時間内ではあまり進みませんでした。	まず関数の使い方を理解しましょう！なんとなくわかったらどんどん演習していこう！
talk: 単位欲しい。	課題進めればきっと単位もらえるよ
talk: 伝言を伝え忘れた	伝えに行かなきゃ
talk: クレーマーがきた	客だからって偉そうだよね
talk: 食パンかじって出かけたら角で人とぶつかった	漫画家よ！！！
talk: 祝日なのに休みじゃなかった	残念！
talk: がんばります...どんどん難しくなって進みもとても遅くなってます。	ゆっくりでもいいので進めることが大切です！
talk: 肩こりがひどい	大丈夫？ゆっくり休んで
talk: パスモを忘れた	切符チャレンジ！
talk: 忘れた	何を忘れたんだい？人間忘れる生き物さ。
talk: 部屋に虫がいる	怖すぎ
talk: ポーズ寒い	どんなポーズ？？
talk: 牛乳買い忘れた	ミルクティーが飲めない
talk: 一人	え、一人楽しくない？自由やで！
talk: チャレンジ問題から難しく感じた。	チャレンジだからね、仕方ない
talk: ColabではちゃんとできてもAtCoderではエラーになってしまう。	そういうこともあるよね、細かいところを確認してみよう！
talk: しかし第6回はあまり数をこなせなかったことが影響しているのか以前までは複雑な問題でもすぐに解法がひらめいていたのですが第6回はひらめきが若干遅くなった気がしています。	使い慣れていない文法が増えてきたからかもね、Google先生にも助けてもらおう
talk: 英語の先生めっちゃ当ててきた	why？
talk: 告白したい	当たって砕けな！
talk: 自転車で転んだ	大きなけががなくてよかった
talk: スタバの新作が売り切れてた	カロリー摂取抑えられたね
talk: 悔しいです。	来週からも頑張ろう
talk: 迷子になった	近くの人に道聞いたら何とかなる！
talk: 雨で服が濡れた	わかる！
talk: 充電コードを忘れた	貸すよ
talk: 親戚の人に久々に会うとき	久々に会う人はなんだか緊張するよね
talk: 鍵なくした	一緒に探そうか
talk: 指挟んだ	痛いね
talk: AtCoderは50(おつり)まで進みました。	その調子！どんどん進めていこう！
talk: ご飯食べるタイミング逃した！	早く寝て朝早く食べよ！
talk: 目の前で乗りたい電車のドアが閉まった	のんびり余裕をもって移動ができたね
talk: 告白するか迷う	悔いのないように！
talk: 怖い夢見た	夢でよかったね
talk: ゴールデンウィークはサボってしまって全然進みませんでした。	休み明け気合を入れ直そう！
talk: 唐辛子が辛すぎる	チーズ入れるといいよ
talk: 夜更かししちゃう	昼夜逆転わかる
talk: 目にゴミ入った	洗い流してー
talk: 難しかった。	気のせいです！
talk: 怪我した	お大事に。
talk: アクセルとブレーキ間違えた	瞬発力！！
talk: 英語が出来る	石油王と結婚出来るんじゃない？
talk: スマホ中毒を頑張って考えていたのですが考えるべき例外が多すぎて挫折しました。	すぐコードにしないで紙を使って落ち着いて整理しよう！
talk: にらまれた	無視しよ
talk: 彼氏と別れた	次の出会いがあるよ
talk: 新発売のお菓子がコンビニ限定…	高いよね…
talk: リモコンがない	探そう
talk: お財布落とした	交番へlet'sgo！
talk: 今日提出の物があった	今から急いでやろう！
talk: お財布を落とした	クレカ止めて！
talk: 内容が懐かしいものばかりで自分やらなすぎだなと感じた。	記憶を呼び起こそう
talk: 上下関係が分からない	敬語使っておけばとりあえずはオッケー
talk: 教職のために後期も履修するつもりでいますが不安です。	プログラミングできると今後絶対いいことあるよ！
talk: チャレンジ問題が難しいです。	チャレンジなので仕方ないよ、どんどん進めよ！
talk: 迎えに誰も来てくれない	待ちぼうけの練習だ
talk: 途中からわからなくなったのを放置していた。	まず週一から始めよ
talk: やる気出ない	一旦休憩しよ！
talk: 明日はテストだ	最後まで足掻こう
talk: 試験が近い	自分を信じて
talk: 授業休講のこと知らずに学校来ちゃった	良い運動だ！
talk: 痴漢された	警察に突き出そう
talk: 待ち合わせの時間間違えた	次は気を付けよう
talk: お土産で買ったものが地元でも売っていた	お土産は思い出なんだから、そんなに落ち込まないで！
talk: 親に言われる	自分の人生なのに。
talk: 服決まらない	なんでも似合うよ
talk: やばい	いい意味？悪い意味？
talk: いいねもらえない	時間帯じゃない？
talk: 占い結果が悪かった	占いは非科学的なものが多いから、気にしなくて大丈夫！
talk: 定期なくした	もっとよく探そう
talk: 今日もつかれた	お疲れ様！
talk: 就活したくない	それな！！！
talk: 疲れて心が痛い	まずは、遊ぼう！
talk: 受験落ちた	頑張ってよかったと思える日が必ずくるよ
talk: 今週は全くすすんでない。	じゃあ来週は頑張ろう！
talk: お店が閉まってる	そんな時もあるよ
talk: 画面オフだと思っていたらオンになっていた	一旦何もなかったかのように退出しよう
talk: ピアス穴が膿んだ	お薬塗るといいよ
talk: 雇ってくれる会社あるかな	たぶんある
talk: 成功するかな	この世に男はたくさんいる
talk: 痩せれない	それな
talk: 次回からのアルゴリズムがとても不安です。	いまから不安がらなくてOK！
talk: 寝れない	アロマとか音楽とかどうかな？？
talk: 待ち合わせ時間間違えてた	次は気を付けよう
talk: 限界まで働いている	無理しちゃだめだよ
talk: 気持ち悪いコメントしてくる人がいる	きもいね無視しよう
talk: 親戚が病気になった	きっと治るよ
talk: スマホの画面割れた	ちゃんと修理できるといいね…
talk: 進路に迷う	自分を信じて！どの選択でも君次第！
talk: リストの範囲が難しく感じました。	リストは苦手な人が多い範囲です、丁寧に学習を進めよう！
talk: スイーツを食べられた	名前を書いておこう
talk: すぐ解けそうな問題はおおよそ解いてしまったのでペースが落ちそうです...。	ちょっと時間かかりそうな問題に着手し始めよう！
talk: テストの裏に気が付かなかった	表は全部解けたの？
talk: 間違えて資料消しちゃった	次はいいの作れるよ
talk: チャレンジ問題にも挑戦したのですが分かりません。	時間をおくとできるかもしれません。とりあえず次の問題に進もう！
talk: 甲子園を逃した	練習は無駄じゃないよ
talk: お菓子がおいしくてやめられない	おいしいからしかたない
talk: 目が痛い	一旦、休もっか
talk: 遅刻しそう	ゆっくりおいで
talk: 面接だ	頑張って！応援してるよ
talk: 悪寒がする	あったかくして寝よう
talk: また改めてwhile、for構文に苦手意識があると思いました。	だんだん薄れてくるから大丈夫！たくさん練習しよう！
talk: でも書ける気がしません。	そんなことない！
talk: 行きたいところに就職できるかな	なんとかなるよ
talk: バカにするように笑われた	それは嫌だね
talk: 悲しい	悲しいね！
talk: 良い言葉が出てこない	伝われば大丈夫だよ
talk: 自分は全然分かってないと落ち込みました。	最初から完璧にわかる必要なんてないよ！友だちと確かめ合ってみてもいいかもね
talk: 乾燥して手が痛い	ハンドクリーム塗らないとね
talk: すっぽかした	そことは縁が無かったんだよ
talk: 最近1問解くのに時間がかかってなかなか進みません。	解き切ることが大切です！
talk: 思うようにいかない	人生甘くないんやで！
talk: 来週模擬授業だ	頑張れ
talk: 靴下がバラバラだった	それはそれであり
talk: これでできたか?と思ってもエラーになってしまってなかなか苦戦しています。	色々な入力を試してみよう！
talk: ゲーム機が壊れた	それは最悪だね、データとか大丈夫？？
talk: フォロワー増えない	そのうち増えるよ
talk: 実行時エラーや不正解の連続で心が折れてしまいそうです。	エラーならコギーが助けになれるかも！
talk: Twitterで悪口書いた	それはやめときな！
talk: 納期を間違えた	何の仕事中？
talk: 空いた時間に演習問題を少しずつ進めよう。	とてもよい心がけ！
talk: B問題が多くいつもより進みが遅くなってしまいました。	B問題は難しいので仕方ない！だんだん慣れていこう
talk: 独り暮らしを始めた	徐々に慣れていくよ
talk: 本を読むのに飽きた	新しいこと始めよう
talk: ジュースこぼした	(･᷄∀･᷅)
talk: パソコンのデータが消えた	なんとか復旧できないかな、、、
talk: 返信に時間が取られる	大事なメッセージだけ返せばいいよ
talk: 他人と気が合わない	それも個性さ
talk: やばいやばいと思いつつ全然進めない自分が嫌になります	パソコン開いたついでにコギーに会いにおいで
talk: 賞味期限切れていた	買ったらすぐ食べよう
talk: 映画を見た	次は一緒に見よ
talk: 切符を無くしちゃった	駅員さんに言えば大丈夫だよ
talk: こけた	誰も覚えてないよ
talk: マスクが嫌だ	マスクはコロナにとても効果があるんだよ
talk: 友達と喧嘩した	仲直りできるといいね
talk: かなり難しいあきらめました。	1週間後には突然解けるようになっているかも
talk: 学校の遠隔用の教室でzoomを受講しているのだが全員静かに授業を聞いているのであまり声を出せる環境ではなくて困っている。	ラウンジとかもおすすめ！
talk: かなり遅れているので不安ですが頑張ります。	そんなことないし、まだまだこれからだよ！
talk: アイディアを貰った	その考え神かよ
talk: あまり進められてないので焦ってます。	一週間で解く問題数を決めるといいかもね
talk: だんだん問題が難しくなっていく中での正解問題数が38なのでペースが周りより遅いことはわかっていたのですが不安が大きくなってきました。	毎週少しでもいいので解き進められるといいね！
talk: 部屋汚い	片付けよう！
talk: 内容が難しい。	プログラミングって奥深い
talk: バイトでお客さんに水かけた	謝ったら許してくれるよ！
talk: 友達の名前を言い間違えた	間違えた！って言ってみよう
talk: 改札引っかかった	ウケる
talk: バイト行きたくない	お金のために頑張ろう
talk: 食べたものが消費期限切れだった	変な味しなかった？
talk: 好きな人今誰といるのかな	きっと家で寝てるよ
talk: テストで0点とった	次がある！
talk: 結婚相手がいない	探す手段はたくさんあるので試しましょう
talk: シフト入ってないのにバイト行っちゃった	そんな日もあるよ！
talk: 友達が数日休んでいる	心配だね
talk: 体調がよくない	しっかり寝よう
talk: 課題を出し忘れた	説得して提出させてもらおう
talk: 終わりに近づいてきてさらに難しくなった。	終わりなので仕方ない、あと一踏ん張り！
talk: あまり進みませんでした。	明日から頑張ろう
talk: 今日誕生日なのに誰にも祝ってもらえなかった	誕生日おめでとう！！
talk: 眼鏡なくした	もう一回落ち着いて探そう！
talk: 課題が同時にたくさん出た	無理はしないでね
talk: 第9回の問題がCが多くて苦戦し時間がかかってしまいました。	少しでも多く解けるように頑張ろう！
talk: リストのところをやっているのですがとても難しく感じました。	全部解き終わった頃にはちょっと難しいくらいになってるよ
talk: だんだん問題が難しくなっていく中での正解問題数が38なのでペースが周りより遅いことはわかっていたのですが不安が大きくなってきた。	毎週少しでもいいので解き進められるといいね！
talk: 新しい服買った	似合ってるよ
talk: いつも難しいなと思っていましたが関数はやはりもっと難しくエラーをたくさん繰り返しました。	関数の引数や返り値を意識しよう！
talk: チケットが外れた	きっと次は当たるよ
talk: 卒業ラッシュすごい	みんなずっといて
talk: 授業の解説時間が長くなっていき難しくなってきたな。	解説時間短くしてもらおうか？
talk: 相手が遅刻してきた	注意しよう
talk: バック忘れた	よくあるよね
talk: 道がわからない	ググって
talk: 半袖は寒すぎた	早くカフェ行こ
talk: 先生に怒られた	あなたが悪いとは限らない！
talk: 写真を撮るの難しい	たくさん撮ろう
talk: 課題あるけどドラマの続き見たい	ちょっとだけ見ちゃう？
talk: バイトでミスしないかな	きっと大丈夫！
talk: 第一志望に落ちた	他の大学でもきっといいことが待ってるはず
talk: 入力例を試して出力例が正しく出たとしても実際提出するとWAで返ってくることが今回の第9回の演習問題では特に多く苦戦しています。	コーナーケースをじっくり考えてみよう！
talk: ばいばい	またね
talk: 炊飯器のスイッチ入れてなかった	ご飯はもうちょっと待とう
talk: 課題の締め切り間違えてた	やっちゃったね、、
talk: フォロワーが増えない	そのうち増えるよ
talk: 車に煽られた	落ち着いて離れよう
talk: 社会人人生不安	Me,too
talk: リップ塗っても乾燥する	本当にそれな
talk: イルミネーション見に行きたいのに混んでる、	混んでるときに行った方が味があるよ
talk: コンタクトなくした	裸眼の世界を楽しもう！
talk: 手越くん卒業しちゃった	しちゃったね
talk: エラーになってしまってなかなか苦戦しています。	色々な入力を試してみよう！
talk: 振り返ってみるとびっくりするほどややこしいやり方で解いていて後悔した。	振り返るのはとても良いことですね！次から気をつければOK！
talk: 必要とされていない	そんなことはないさ！
talk: 食べたいものが多すぎて辛い	運動すれば大丈夫
talk: 足つった	痛いよね
talk: 情報取集たくさんできる	それはいいこと！
talk: 部屋の電気消さずに家でちゃった	あるある
talk: 早く帰りたい	残ることでできる人間関係もある！お疲れ様
talk: 部屋にゴキブリが出た	怖すぎ
talk: 問題でつまずきそこで心折れました。	そういう時はどんどん新しい問題にチャレンジしていきましょう！
talk: スマホの動作が変	たまにあるよね
talk: チケットの抽選期間終わっていた	きっと運が溜まっているよ！
talk: 冷たい飲み物が売り切れ	地味に辛い
talk: ミュートし忘れて悪口言っちゃった	一旦何もなかったかのように退出しよう
talk: 注文を言い間違えた	言い直せば大丈夫！
talk: list使うの苦手です...。	リストは使用頻度高めなので、ぜひ練習してください！
talk: やらかした	君が思っているより、他人は何とも思わないぜ？気にせず挽回が大切。
talk: ペン忘れた	スマホかパソコンでメモしよう
talk: 少し話が難しくなってきました。	まだまだこれからです
talk: 寺田蘭世さんが芸能界から引退しちゃう	悪いニュースだね
talk: 問題がなかなかうまくいかず悩みました	悩むのも一つの勉強です
talk: 友達に会えなかった	明日はきっと会える！
talk: for文や演算系(+=など)を使うべき問題が難しかった。	使うべきだと気付いただけでもオッケーです！スラスラ書けるようになるとなお良いね！
talk: 泥棒が来るかもしれない	ちゃんと鍵を閉めていれば入ってこないよ!
talk: 犬が脱走した	追いかけよう！！
talk: やっと1週目の課題が終わりました...!長かったですね	お疲れさま！長い戦いです
talk: 特定の人にだけ引用リツイートされる	ブロックしちゃえ
talk: ハブられた	私がいるよ！
talk: 家計簿の計算が合わない	おかしいな
talk: なかなかアルゴリズムになってから思うように進まない。	完璧に書けるようになるには結構時間かかります、頑張って！
talk: 別れたい	よーく考えてから決めればええ。
talk: 好きな人に彼氏ができた	あの人イマイチだったよ！他にいい人いるよ！
talk: 下着一泊分忘れた	新しいものを買ういい機会だ
talk: インターン忘れてた	そこまでの会社だったってことだよ
talk: バカ丸出し	バカの方が楽しいよ！
talk: 蚊に刺された	ムヒ！
talk: 友達はもう30問目に進んでいると聞き少し焦り始めてきました。	その友だちがすごすぎるんだよ、自分のペースで進めてね！
talk: 見ていて寒い	暖かそうな服をおすすめしよう。
talk: 課題が終わらない	徹夜だ！！
talk: 鍵忘れた	忘れないように玄関に置こう
talk: 預金が難しい。	紙とペンを使って問題を整理してみよう！
talk: 寝ぐせついたままだった	なおせそう？
talk: 友達に気の利いた声をかけてあげられない	あなたは十分できてるよ
talk: トイレにスマホを忘れた	まだあるといいね
talk: 今週の課題はなんだか難しくてあまりスムーズに進めることができませんでした。	だんだん難しくはなっていくけど、一歩ずつ進めていこう！
talk: ダイエット続かない	なかなか難しいよね、、
talk: 混雑に巻き込まれた	時間をずらそう
talk: 返信がこない	相手も忙しいんだよ
talk: 勉強したくない	頑張ったら良いことあるんじゃない？
talk: 課題が終わらない	焦らず着実に進めてこ
talk: うんち踏んだ	運がついてくるよ
talk: 今日の夕飯何つくろうかな	自炊してるのえらい！
talk: 今回の範囲は難しく進まなかった。	まず1問！
talk: 自転車がパンクした	徒歩帰宅？
talk: かなり時間がかかってしまった。	それだけ長い時間プログラミング練習していて偉い
talk: 炭酸が爆発した	強い炭酸ってことが分かったね
talk: Twitterでポエム書く人痛い	地味にそのポエム響いたりするよね
talk: 問題自体はクイズみたいでアルゴリズムを考えつくことは比較的容易なのですがコードで表現する部分に苦戦しています。	クイズみたいって思えるんだね！楽しそう！コードはパターンをいくつか覚えておくと楽に書けるようになるかも！
talk: 新学期が始まる	楽しんでいこう
talk: 数回前の授業から既に授業きついていけていませんでした。	ぜひ復習を！
talk: 全然わからない	私も分からない！おそろいだね！
talk: 日焼けした	それは痛い
talk: 実験レポートを忘れた	そんな時もあるよ
talk: V6が解散した	寂しいね
talk: 満員電車に乗ってしまった	嫌だよね
talk: 予約忘れてた	今からでも間に合うかもしれないよ
talk: 転んでズボンが破けた	ええええええぇ！？どんな状況？？！
talk: 前回より少しだけ進んだ気がします。	応用なので仕方ない！少し時間を空けてもう一度チャレンジしてみよう！
talk: 他の方の回答をみてみるとそんなに簡単にできるのか!と思う。	そうやって他の人の回答を見るのも一つの勉強です！
talk: ニキビできた	皮膚科行こ
talk: 今日もAtCoderをやりましたがほとんど手詰まり状態でした。	友だちやコギーを頼りながら、少しでも進められるようになろう！
talk: 自分より才能がある人に嫉妬する	少しずつ努力しよう
talk: 写真写り悪くて載せれる写真ない	風景とか載せとけ
talk: 電車に乗り遅れた	乗り換えでダッシュ！
talk: 短気かも	すぐに熱くなれるんだね
talk: テスト赤点	知ってた？アインシュタインは物理の成績悪かったんだよ！あれ、ガリレオだっけな？
talk: お申し出受けた	堂々としてれば大丈夫
talk: アルゴリズムはやっぱり難しいです。	アルゴリズムはまず知識を身につけないとね
talk: プログラミング苦手で結構難しかったです。	だんだん慣れてくるはずです！頑張って！
talk: 郵便が届かない	気長に待ってみよう
talk: 近所のラーメン屋が潰れた	他店に食べに行こう
talk: 自分が不愛想だと思う	不愛想じゃないよ
talk: 今週の講義はとても難しくてまだしっかりと理解できません...。	こまめな復習や演習をお忘れなく！
talk: メイクが上手にできない	youtubeで勉強しよう
talk: 食べられないものがある	それだけ残そう
talk: 服逆だった	まじか、気づかなかった
talk: 一問あたりにかかる時間が長くなってきました。	解き切ることが大切！
talk: 野菜嫌い	無理しない程度に慣れよう
talk: 1年のプログラミング実習の成績が悪く少し不安です。	今年から頑張ればいいんだよ
talk: 腰痛い	大丈夫？重いものとか持たないようにね！
talk: 新入生の名前と顔が一致しない	覚えようとしていることがすごい
talk: ご飯を食べ忘れた	次食べるご飯はおいしいだろうなあ
talk: 面接がむずかった	いい結果くるよ！
talk: フォロワーが伸びない	通信が重たくならずに済むね
talk: 友達に質問しずらくなってきた...。	向こうはそんなに気にしてないと思うよ
talk: ほかの中間試験が一通り終わったのでこの授業も本腰入れておこう。	ぜひお願いします
talk: 友達怒ってないかな	思い違いってことよくあるよ
talk: 好きだったドラマが終わってしまう	来クールにもっとハマれるドラマがあるかもよ?
talk: ズボンのファスナー開いてた	どんまい、気づいてない人も多いと思うよ
talk: 新しい服を買った	似合ってるよ
talk: 今日はよくミスをする	そんな日もあるよ!
talk: 達成できるか不安です...。	頑張るしかない！
talk: 家を出たら財布を忘れた	今日は一日ヒモになろう
talk: 授業長かった	お疲れ様！
talk: 今まで飛ばしていた問題を解いていたのですがそれも難しい。	あら、解けている友だちがいたらヒントをもらうといいかもね！
talk: c問題はやることが多くて大変です	C問題を解けるようになれたらすごい！
talk: 虫歯痛い	いよいよ歯医者に行く時だ
talk: お皿を割ってしまった	怪我がなくてよかった！手袋とかで滑らないように気をつけよう!
talk: 就職先決まるかな？	大丈夫！心配しなくて大丈夫だよ！
talk: ダンスが覚えられない	練習あるのみ！たくさん練習頑張って
talk: 結婚できるかな	きっとできるよ
talk: 最終どのくらい終わらせられることが出来るのか不安です。	きっとどうにかなってるから大丈夫
talk: 虫歯になった	いよいよ歯医者に行く時だ
talk: ライブに落選した	ドンマイ次あるよ！
talk: また改めてwhile、for構文に苦手意識があるなあと思いました。	だんだん薄れてくるから大丈夫！たくさん練習しよう！
talk: 最近追いつけていなくて焦ってる。	まず例題や基本問題から進めていこう！焦らなくて大丈夫！
talk: また土曜日にABCに参加しましたがA問題しか解けませんでした...	ABCに参加することが偉い！
talk: 課題のやる気が出ない	頑張れ！
talk: 友達の名前を間違えて呼んだ	そういうときもあるよね
talk: 雨で洗濯ができない	晴れないかね
talk: 視力が悪い	画面とか見る時間多いもんね
talk: 発表をうまくできるかな	不安ならとことん練習あるのみ！
talk: 服が逆だった	まじか、気づかなかった
talk: スマホが繋がらない	気をつけてね
talk: A問題はすらすら解けるようになったがB問題が全然解けない。	B問題とA問題は難易度結構違うからね、練習あるのみ！
talk: 顔が汚れて力が出ない	新しい顔だよ！(⚈⚈͜⚈)彡
talk: だんだん難しくなってきているとひしひしと感じています。	まだまだこれからですよ
talk: 酔っ払いに絡まれた	上手くかわそう
talk: 冬服ない	買い物に行こう
talk: 階段から落ちた	七転び八起き
talk: 集中力ない	好きなものじゃないと難しいね
talk: 眠い	お昼寝しとく？
talk: 怒られた	次に活かそう
talk: かぐや姫が月に帰った	実家に帰っただけだよ。また帰ってくるよ。
talk: みんな見てるところで1人でこけた	そんな時もある、次はいいことあるよ”
talk: 今週は全然手をつけることができませんでした。	来週から覚醒するのかな
talk: 少しペースが遅かったためゴールデンウィークの間に進めたのですが同じルームの子に追いついただけだったので悔しいです。	その子がめっっちゃ早いんだよ、焦らずやっていこう！
talk: 友達が待ち合わせ時間に来ない	きっと来るよ!
talk: AはできるようになったけれどもまだBとCは難しい。	そしたらB問題をスラスラ解けるように特訓だね！
talk: 人前でうまく話せない	予行練習して話す前に深呼吸しよう
talk: サンタさんが来ない	大人になったね
talk: メイクがうまくいった	超かわいい
talk: 外食したら行列が…	きっと美味しいんだ！
talk: これだ!と思って打ち込み結果にREが出てくるとへこみますね...(涙)	わかります、そんなときはぜひ話しかけてね
talk: フォロワー伸びない	通信が重たくならずに済むね
talk: 想像以上に忙しく進められる時間がない。	パソコン開くついでにコギーに会いにきてね
talk: 味方いない	そんなことない
talk: 部屋汚い	掃除しよう
talk: お金全然ない	それは頑張れ
talk: カードが使えなかった	そんなお店願い下げだわ
talk: ケーキが売り切れちゃう	残りものには福がある
talk: 家の鍵忘れちゃった	誰か帰ってくるまで時間潰しに行こ
talk: このコードが何をしているのかよくわからない。	一行ずつコードを整理しながら追っていこう！時間がかかるけど、一番理解は深まります！
talk: 仕事覚えられるかな	いけるっしょ！
talk: 朝たまたま見た占いの結果が悪かった	気にしなくて大丈夫！
talk: 友達の傷つくことを言ってしまった	謝ってみよう
talk: 寒い	風邪ひかないように温かくしてね
talk: 遊びに行く日に雨が降った	雨の日しかできないこと考えよ
talk: ティッシュ洗濯物の中に	私もよくやっちゃう…
talk: 関数難しかったです。	複雑なプログラムになるほど、関数は大切になってきます
talk: スマホを忘れた	電気代が浮く
talk: 簡単ではありません。	難しい部分は多いけど、たくさん問題を解いて慣れていこう！
talk: 炎上してる	あれま
talk: 階段が辛い	いい運動になるね
talk: 自分の失敗を人に笑われた	笑った人は時間が経てば忘れると思うから、気にしないで!
talk: 将来が不安	私も不安すぎる
talk: 倉光先生は優しいので単位は取れるだろう	コギーもそうだと思う
talk: お金返ってこない	それはやばい。催促すべきじゃない？
talk: 夜道が暗い	気をつけて！
talk: けがをした	けがだけで済んでよかったね
talk: 熱心に教えてたらウザがられた	情に熱い良い人だと思うよ
talk: 恋人に振られた	新しい出会いあるよ！
talk: AtCoderの難易度にあわせたカウントがでましたがAは本来であれば0.2ということでAでも何回も間違えているので軽くショックを受けました。	誰にでも間違いはあるし得意不得意はあります！自分なりに頑張ってみよう！
talk: 卵が一つもない	買いに行こう
talk: 教科書を忘れた	友達に見せてもらおう！
talk: 嫌いなシフト被った	コミュ力上げるチャンス！
talk: 食べ過ぎた	運動すれば大丈夫
talk: ポーズが寒い	どんなポーズ？？
talk: 鍵をしめ忘れた	早めに帰ろう
talk: 家にスマホ忘れた	なくてもなんとかなる
talk: 献立思いつかない	検索すれば美味しいもの出てくるよ！
talk: 彼氏に振られた	新しい出会いあるよ！
talk: また慣れないアプリで苦労しています。	3週間後にはきっと慣れます、大丈夫
talk: 間に合わなかった	まだ待ってるかも
talk: 爆音宣伝トラックが通りかかった	イヤフォンで遮断しましょう
talk: 何回やり直しても正解にならない。	たまには飛ばして進めてもいいと思うよ
talk: グッズ売り切れ	それはつらい
talk: 今日はPCの調子がおかしく全然進みませんでした。	明日になったら機嫌良くなるかも！
talk: クリぼっち	一人の時間も大事
talk: 失敗した	過去から学び、今日のために生き、未来に希望をもとう。
talk: 最初は感覚や文法が思い出せずに苦戦してしまいました。	だんだん感覚が戻ってきますよ、頑張って！
talk: 賞味期限が切れていた	買ったらすぐ食べよう
talk: 卵割れた	今日は卵焼きにしよう
talk: 鼻水が止まらない	今日は寒いね
talk: 服に虫がついた	きっしょ
talk: 味方がいない	そんなことない
talk: B問題が多く難しかったためいつもより進みが遅くなってしまいました。	B問題は難しいので仕方ない！だんだん慣れていこう
talk: ゲームが攻略できない	地道に進めよう
talk: フォロワー少なすぎ	私がいるだろ
talk: 高級パンケーキ焦がした	ぴえん越えてぱおん
talk: 制限きた通信制限ー	Wi-Fi活用！
talk: 進んでいなくてかなりまずい。	じゃ、いまから3問解こ
talk: ティッシュが洗濯物の中に	私もよくやっちゃう…
talk: バイト先の人と合わない	仕事に集中して放っておけばOK
talk: 他人の傷つくことを簡単に言う人がいる	ひどいね
talk: 服に虫ついた	きっしょ
talk: 生きているのがつらい	一人じゃないよ
talk: 先週に比べかなり難しかったです。	たしかに難しかったかもしれないけど、まだこれからです！
talk: どうしても思いつかず他の人が解答したプログラムを見てprintで途中を表示しながらこういう流れだと理解することが増えていて自分の力になっているのかが不安です。	printでデバッグするのも一つの大事なプログラミング技術ですよ！理解できたならよしとしよう！
talk: 自分のペースが落ちていることに焦りを感じます。	単元が進んで難しくなれば、ペースが落ちるのは当たり前です。諦めずに進めよう！
talk: 人に話しかけられない	難しいよね
talk: 二重誤差が難しい。	難しいよね、わかります。
talk: ほしいものが買えなかった	次はちゃんと予約しよう
talk: 風邪が治らない	無理しないで
talk: 今は文字列に取り組んでいるのですが0から数えなくてはいけないことを忘れてしまったり組み合わせ方が難しいと思いました。	手を動かして慣れていきましょう！
talk: コンタクト落とした	今日はメガネでイメチェンだ！
talk: 筋肉痛で足が痛い	ストレッチして、ゆっくり休んでね!
talk: お金全部使っちゃった	また稼げば良いよ
talk: パンクした	腕力鍛えられるね
talk: 最初の30問くらいよりも難しい問題が増えてきたように感じます。	資料も見ながらどんどん進めていこう！
talk: 頑張ればA、A+は必ず取れるので明確な基準設けてくれるのありがたいと思いました	そうです、目指せA+
talk: 皆スーツだった	笑笑
talk: お店で頼んだ飲み物がまずかった	店員さんに言ってみよう
talk: 推しが卒業…	それは無理
talk: どこかに出かけたい	時間調整して!
talk: インターン落ちた	応募しただけえらい
talk: 周りが就活進んでて焦る	それな
talk: 傘忘れた	その分荷物軽いね
talk: わからない問題があった場合飛ばして解くのですがそうするとどのコードを使えばいいかわからなくなることがあります。	コメントとかでメモっておこう！
talk: 肘をぶつけた	肘ぶつけるとジンジンするよね
talk: 見過ぎちゃう	他にやることあるでしょ
talk: 彼氏ができない！	焦らずいこ～
talk: 更新めんどい	しなくても良いのよ
talk: 悪いことが起きることを恐れる	気にしすぎ！
talk: 演習問題はチャレンジ問題で詰まってしまい悲しかった。	チャレンジ問題まで行けたなら素晴らしい！時間をあけて復習として取り組んでみても良いかも
talk: 靴汚れた	洗えばいい
talk: 夏休み終わった	もうすぐ冬休みくるよ
talk: 友達が同じことを何度も聞いてくる	しつこいのは嫌だなぁ
talk: 無視された	気づいてないだけだよ
talk: 一問あたりにかかる時間が長くなってきた。	解き切ることが大切！
talk: カップルの惚気が多すぎる	ほほえましいね
talk: これ分かんない	教えてあげるよ
talk: 口内炎痛い	ビタミン摂って！
talk: テストができるか分からない	予習を頑張ろう！
talk: A+取りたい!	がんばれ！
talk: すべての授業が終わってるまでに問題が解き終わる気がしないです。	きっとどうにかなっている、と信じよう
talk: 明日は面接だ	頑張れ
talk: 家の鍵閉め忘れたかも	確認しに帰った方がいいよ！
talk: 弟が反抗期	そのうち終わるよ
talk: パスモがなくなった	見つかるといいね
talk: 社会で生きていけるかな	なるようになる！
talk: 何度もエラーを連発しとても悲しい。	エラー5連続くらい出しちゃったら一回休も
talk: 好きなユーチューバー配信やめた	他のユーチューバー探そう
talk: エラーになったときの原因が分からない。	そうだよね〜、勉強を進めていくとある時突然わかったりもします
talk: イベントが中止になる	楽しみにしてたのにね、、
talk: 「こうやって解くのか!」という発見も学習であることは承知している重々承知のですが誰かの発想をほぼそのまま拝借するのもちょっと悔しいです。	たくさんの人の発想や解き方を知る機会も大切です！それを組み合わせると新たな発想が生まれるかも？
talk: 疲れた	お疲れ様^_^
talk: 料理してたら指切った	絆創膏あげようか？
talk: 電話も出ない	少し時間をおこう
talk: 就活どうしよう	先輩や先生に相談しよう
talk: 今日はなかなか疲れましたね...	そういう日もあるよね、明日も頑張ろ
talk: 着ている服が寒そう	暖かい服を着せよう
talk: 友達に騙された	もう騙されないぞ！
talk: 提出期限間に合わなかった	4回まではセーフ
talk: 二重誤差が難しかったです。	難しいよね、わかります。
talk: 授業中に半分くらいしか進まないので毎回の課題が溜まってしまいます。	授業時間以外にもプログラミングの練習をしよう！
talk: 人の気持ちを読み取れない	難しいよね
talk: いじけてないかな…	大丈夫！
talk: 第6回の演習問題の後半は複雑に感じて提出までに時間がかかった。	時間がかかっても解き切ることが大切です！その調子！
talk: レポート出し忘れた	次がんばろ
talk: 変な人に絡まれた	逃げた方がいいね
talk: データ飛んだ	ゴミ箱確認！！！
talk: 風邪治らない	無理しないで
talk: 仕事で失敗した	失敗を生かそう
talk: お店定休日だった	他のお店探してみよう
talk: 毎日AtCoderをやる習慣がせっかくついたのにくじけそうです。	めちゃくちゃ偉いじゃん！くじけないで続けてね！
talk: 八つ当たりされた	聞き流そう
talk: フォロー外された	きっと間違っちゃったんだよ
talk: 冷めやすいんだよね	いろんな事を体験できるじゃん
talk: バイトミスった	所詮バイトなんだからそこまで気にせんでええ。
talk: 自転車とぶつかりそうになった	危ない！
talk: 画面を見すぎて目が疲れた	一旦、休もっか
talk: バカって言われた	バカっていう方がバーカ！
talk: 味付け微妙	失敗は成功のもと！
talk: わからないところを飛ばしてどんどん進んでしまっているので進捗はあまりよくない[と思[う。	気のせいだと信じて先に進もう
talk: バッドエンドの映画を見た	悲しいね、、
talk: 好きな俳優が問題を起こした	わかる、、
talk: 怒ってる人と同じ空間にいるとき	私だったら怖くて逃げちゃう
talk: また今回の範囲はB問題でも他の人の解答を見ないとわからないようなものがありまだまだ全然だなあと思った。	B問題もたまに難しいよね、ぜひ色々な人の解答からアイディアや書き方を盗んでください
talk: 歯ブラシ買い忘れた	違う種類の試すいい機会だ
talk: 集合時間早すぎ	早起きは三文の徳
talk: 忘れ物をした	取りに帰る？
talk: メール違う人に送っちゃった	その人と話す機会ができたね！
talk: 夜更かししてしまう	同じく
talk: B問題が多くてかなりつまずきました。	B問題は難しいよね...けど練習していけばできるようになります！
talk: マウントをとられる	気にしちゃだめ
talk: 実験実習費の納入が間に合わなかった	締め切り過ぎてても大丈夫だよ
talk: ピアノの発表会がある	いつも通りやれば大丈夫
talk: 親戚の話が長い	大変だよね〜
talk: 何度か考えたり手を動かしてみましたが難しくて正解することが出来ませんでした。	まず考えるとか手を動かすことが大切なので十分です！だんだん正解できるようになっていきますよ
talk: ちょっと焦ってきた。	どんどん解くに尽きる
talk: 入会費高い	その分いい経験ができることに期待しよう
talk: 毎日やることがたくさんある	毎日頑張ってるの知ってるよ
talk: 試験範囲間違えてた	自分を信じて
talk: ささくれできた	保湿しよう
talk: 可愛くなりたい	出来ることから始めよう
talk: 偏頭痛がする	無理しないでね
talk: 寝違えちゃった	痛いよね、まずは安静にして様子をみよう
talk: LINEの通知がこない	設定だね
talk: 裏アカがばれた	笑笑
talk: プログラミングの内容が複雑になってきて考えるのに苦労します。	それをできるようになってこそ！
talk: ギャグが寒い	どんなギャグ？？
talk: よく怒られてしまう	それだけ期待されてるってことだね
talk: 粒餡派が少数で辛い	私、粒あん派♥
talk: バイト先に馴染めない	私のバイト先どう？
talk: 赤切れで手が痛い	保湿保湿！
talk: 性格悪い人が苦手	得意な人はいない
talk: 集合時間がわからない	聞いてみよう
talk: 課題の提出日まで課題をやる日がない	徹夜だ！！
talk: 次回以降も解けるか不安。	不安になることはないけど、じゃんじゃん解いていこう！
talk: ブロックされていた	ブロックしかえそう
talk: 服に染み付いた	クリーニングだわ
talk: 関数が苦手なので理解するのが難しかったです。	演習課題で慣れていこう！
talk: 迷惑メール	無視無視！
talk: 好きなアイドルと会えた	一生の思い出じゃん
talk: データが吹っ飛んだ	それは辛すぎる、次はバックアップしとこう…
talk: 友達と予定が合わない	その子に嫌われているのかも
talk: 特にfor文や演算系(+=など)を使うべき問題が難しい。	使うべきだと気付いただけでもオッケーです！スラスラ書けるようになるとなお良いね！
talk: ストーリーに講義資料写ってる	流出はダメだよ
talk: 大きいクモに遭遇した	クモは益虫だから、出ても気にしなくてOK
talk: 大事な書類が破れた	どうしよう
talk: 割と忘れていたことも多かった。	少し前の問題も解いてみると良いかもね！
talk: 風が吹いていて寒い	冬だね～
talk: 上司に八つ当たりされた	そんなに深刻に受け止めずに流して聞けばOK
talk: 寝坊して選考受けられなかった	この会社には縁がなかったと思おう
talk: 彼氏の名前を呼び間違えた	やらかしたな
talk: 飛行機乗り遅れた	仕方ないからリカバリしていこう
talk: 二乗誤差で見事に沼りました。	沼から抜け出す突破口を見つけるんだ！
talk: 自分がこのグループにいていいのかわからない	いていいんだよ！
talk: 家から出たくない	遊びに行っていい？
talk: 時間を見つけて楽しく解いてはいますが目標のACの数に届くか心配になってきました。	楽しく解けてるならいいじゃん！
talk: 抽選が外れた	次は当たるよ
talk: スーツケースの鍵なくした	あかなくてもどうにかなる
talk: 1時間くらい格闘しましたが負けた。悔しい！	明日になったら勝てるかも
talk: 指切った	絆創膏あげようか？
talk: プログラミングが長く複雑になってきていて大変だ。	長いと厄介だよね、短くかけるところがないか探してみてもいいかも！
talk: 靴下左右で違った	新しい靴下買っちゃお！
talk: 欲しかったグッズ売り切れてた	残念だね、、再販待とう
talk: 情報コースに進みたいと思っている。	ぜひぜひ
talk: 第8章から解説を見ながらでないと解けなくなってきていて焦ります。	まずは解説を理解するところから始めよう！
talk: 第2回の範囲は途中で止まってしまっている状態です。	時間があるときに続きもやってみて！
talk: 綺麗な景色が一瞬で消えてしまう	一瞬だからこそ良いよね
talk: お金が全然ない	それは頑張れ
talk: ユーザ名が明らかに自分すぎて演習問題の進み具合がバレるかも。	頑張っている感をアピールしてこ
talk: 足を踏まれた	なんそいつ
talk: 肩凝った	お疲れ様
talk: 友達が増えた	私にも紹介して！
talk: ライブ外れた	次当たるよ！
talk: スマホの画面が割れた	ちゃんと修理できるといいね…
talk: 長引いた	その分勉強できるね
talk: 最初の4問だけ解けましたがそれ以降は本当に難しくて歯が立ちませんでした。	4問解けただけでも優秀じゃない？
talk: 提出し忘れた	今月はゆっくりできるね
talk: 果たしてこのコードを理解し更にかけるようになる日は来るのか。	絶対来ます！
talk: 充電切れた	充電器貸してあげる
talk: ドタキャンされた	そのことはもう遊ぶのやめよう
talk: 弟が学校に行かなくなっちゃった	お布団巻き巻きで歩いてみよ
talk: 太った	食べる量減らしてみたら？
talk: 好きな俳優引退した	新しいすきを見つけに行こう
talk: イケメン見つけた	最高じゃん！
talk: 告白するタイミングを逃した	まだタイミングはこれから来るはず！
talk: 結婚出来るかな	きっとできるよ
talk: ゴミ出し忘れた	やっちゃった〜
talk: 明日面接だ	頑張れ
talk: ペットが死んじゃった	いつも心の中にいるよ
talk: 子供が挨拶してきて困ってしまった	返してあげれば喜んでもらえるかも
talk: 荷物重すぎて運べない	カート使おう
talk: あと一つ。	あと少し！頑張って！！
talk: 膝痛い	無理しないで〜
talk: 推しが尊すぎる	それなー
talk: 考えてみたのですがエラーになってしまいわかりません。	少したったらできるようになるかも！
talk: 火を消し忘れたかも…	いったん戻るしかないかも
talk: 働きたくない	それな！
talk: ただ、その次の問題が難しいです。	ドツボにハマった時は、きっと時間が解決してくれるよ！
talk: 友達と喧嘩しちゃった	仲直りは早い方がいいよ
talk: 体調管理を失敗した	体調は天気や状況でも変わるから仕方がない
talk: 前の授業でできなかったところをどう解決したら良いかわかりません。	少し時間をあけてもう一度挑戦してみよう！
talk: 応募期間過ぎてた	次の機会にかけよう
talk: 先週に比べかなり難しい。	たしかに難しかったかもしれないけど、まだこれからです！
talk: ストーリー非表示にされてた	自分のも非表示にしておこう
talk: 進んでいなくてまずい。	じゃ、いまから3問解こ
talk: 派手に転んだ	大丈夫？
talk: トイレットペーパーをきらした	ペーパーがなくなったことに気づけたのがえらい
talk: 提出の課題持ってくるの忘れた	次回忘れないようにしよう
talk: 来た道覚えられない	感覚に頼らずにマップ見て帰ろう
talk: ミートソースをこぼした	うわああああああ！
talk: 友達に否定された	気にすることじゃない
talk: 簡単な並び替えなら簡単だが複雑になるとわからなくなる。	できるだけ簡単に書くように心がけでみよう！突破口があるはず！
talk: 課題難しすぎる	簡単という人はいないよ
talk: 時間の使い方が下手	難しいよね
talk: ガシャポンで欲しいものが出なかった	きっと今は運を溜めている段階だから落ち込まないで！
talk: スマホ使えない	スマホ使えない時も意外と楽しいよ？
talk: 宿題家だ…	ドンマイ
talk: ずっとゲームをしてしまう	時間決めてやる
talk: ケーキ売り切れちゃう	残りものには福がある
talk: 焦りしかない今回の授業のブレイクアウトルームで個別にメッセージしてもらえそこから質問できたのでつまづいていたところをクリアできた。	人を頼るって大事
talk: 予定埋まらない	私と遊ぼう
talk: ESの期限間違えた	違う企業でも似てるような会社あるはずだよ！
talk: 友達の状況を知れる	確かに！
talk: 財布がないことに気付いた	皿洗いをして帰りましょう
talk: AtCoderでは2問目からつまづいてしまいました。	じゃあ3問目といてみよう！
talk: 課題が終わらなくて徹夜した	パチパチ！提出忘れないでね
talk: 服の色が寒そう	寒色も良いぞ。
talk: 今日は1日忙しかった	お疲れ様！ゆっくり休んでね
talk: 喉痛い	のど飴食べる？
talk: バイトに落ちた	コロナだからしょうがない
talk: 外寒い	冬〜って感じ
talk: 買ったばかりのネックレスなくした	それは悲しいね
talk: お風呂の栓が外れてた	それめっちゃショックなやつ…
talk: リストのところをやっているのですがとても難しく感じた。	全部解き終わった頃にはちょっと難しいくらいになってるよ
talk: 集合時間わからない	聞いてみよう
talk: 課題を提出し忘れた	説得して提出させてもらおう
talk: 今日は前回に比べてあまり進まなかった。	明日もまた一緒に進めよ！
talk: 集中力がない	好きなものじゃないと難しいね
talk: 友達に似てたから話しかけたら全く知らない人だった	そのひととも友達になろう
talk: 不審者に遭遇した	大丈夫だった？
talk: やっと課題が終わりました...!長かったですね	お疲れさま！長い戦いです
talk: なんだか友達にハブられてるような、	考えすぎじゃない？
talk: 明日の試合勝てるかな	応援してるよ
talk: きちんと先生にも反映されているか心配です。	きっと大丈夫
talk: オートロックで追い出された	服着てただけまし
talk: イライラする	寝ればおさまる。
talk: 明日はゼミの発表だ	大丈夫だよ
talk: これが”挫折”か......と悟った。	これからもプログラミングは必要になってくるので、挫折せず頑張って！
talk: 料理を作りすぎた	たくさん食べられるね＾＾
talk: ジムに行きたいのにちゃんと通えるか不安でいけない	やる気次第
talk: 今週の内容とても難しい。	ぜひ時間をかけて復習してみてください
talk: 授業の内容が難しくなり焦っています。	焦ってもしょうがないので、こまめに復習しよう！
talk: ライバルに負けるかも	負けないようなことしよう
talk: さぼりすぎてる	休むことも大切
talk: ちょっと難しかったです。	ちょっとなら優秀！この調子で進めてね！
talk: なぜ気づかなかったのかとショックを受けました。	気づけるようになれれば十分！
talk: 予定入り過ぎている	一回整理してみたら
talk: ニキビ痛い	バランスよく食べよう
talk: 卒業しちゃった	何事も終わりはあるんやで？さあ、新しい領域へ！HaHa
talk: 想像以上に忙しく進められる時間があまりありません。	パソコン開くついでにコギーに会いにきてね
talk: 身長が伸びない	カルシウムとろう
talk: 楽しそうな投稿がうらやましい	こっちも楽しもう！
talk: 洗濯してしまった	後始末が大変だ
talk: 渋滞に引っかかった	みんなでゲームでもしよ！
talk: 終電逃した	サイゼ行こうか
talk: 一週間で10問ペースと考えると参ってしまいます。	1日1問とどっちがいい？
talk: 就職できるかな	なんとかなる！
talk: 給食の揚げパン落とした	ドンマイ（;;）
talk: お金が無い	一緒にバイト始めよう！
talk: 貢がせてくれない	正しい方向なの？
talk: 物覚えが悪い	なんでも覚えるのは大変だよね
talk: 単位とれなかった	来年頑張ろう
talk: 連絡ミスをした	謝罪連絡しよう
talk: 少しずつ慣れてきたいです。	3週間後くらいには慣れますよ
talk: 漢字の変換を間違えた	直せばいいだけ！
talk: 知っている子がいなくて相談などはできませんでした。	いい機会なので知り合いを増やしていこ
talk: 頭の中がごちゃごちゃになってすごく時間がかかってしまいました	紙とペンで整理してみよう！
talk: 鍵をかけ忘れたかも…	ゆっくり自分の行動を思い出して
talk: 文字列の置き換えの問題が難しい。	文字列は難しいですが、演習あるのみ！
talk: 雨が降ってきた	タイミング悪しだね
talk: 入院した	容体は？
talk: 電車に間に合わなかった	乗り換えでダッシュ！
talk: 苦いカクテルを頼んでしまった	鼻つまんで飲むといいよ
talk: プログラミングのことを忘れていて少し苦労しました。	少しやらないとすぐ忘れちゃうよね、わかる。定期的に練習できると良いね！
talk: トイレめっちゃ並んでる	ドンマイ！
talk: やってみたいけど勇気が出ない	チャレンジしてよくないことはあまりないからやってみるのがいい
talk: Gに遭遇した	戦闘態勢！
talk: 難しくて一度断念。	また明日やってみよ
talk: テスト0点だった	伸び代だらけ！
talk: 特にチャレンジ問題が難しい。	チャレンジ問題は地雷級に難しい時もあります。まず基本を一通りマスターしよう！
talk: 話しに割り込んでくる	一言声掛けたら？
talk: 雨が降ってきた	傘ある？
talk: 何から手を付けていいかわかりません。	まず例題の理解から！
talk: Pythonもなかなか答えにたどり着けなくなってきて悔しい。	悔しさをバネにして、ぜひ答えを見つけてください
talk: 電車で貧血になった	それは辛い
talk: 頑張ったのでお腹が空いた!	ドッグフードを分けてあげたい
talk: 購入の予約を忘れた	買えることを祈ろう！
talk: ガチャが外れた	どんまい
talk: 自分に自信が持てない	下には下がいるよ！
talk: アカウントを作りたい	調べよう
talk: 髪の毛染めたら変な色にされた	その美容院には2度と行かないようにしよう
talk: 筋トレ続かない	5分でいいから続けよ
talk: お腹が減った	キットカット食べる？
talk: 挫折した	人生諦めも重要。
talk: 床に落ちてた犬のフンを踏んでしまった	運が付いたと思おう
talk: 風邪かも	お大事に
talk: ゲームで全ロスした	ご愁傷様です
talk: 低気圧のせいで頭が痛い	今日はゆっくりしよう
talk: 分からなくて全然理解できなくてやばいって思ってます。	まずはコードを動かして、print文を入れながら理解を深めよう！
talk: 乗る電車間違えた	間に合えば大丈夫！
talk: 今日の振り返り	自分が気にしてても相手は気にしてないよ
talk: 寝過ごした	私も１時間くらい寝過ごしたことあるから大丈夫！
talk: 推しがクビになった	推しのセカンドキャリアも応援しよう
talk: JCB使えなかった	そんなお店願い下げだわ
talk: 今回解いた問題の判定がTLEばかりでメンタルがやられました。	TLEは辛いよね、計算量をしっかり考えてみよう！
talk: 楽しい	よかった！
talk: AtCoderですがログインすることができずまだ演習ができておりません。	すぐログインできるようになろう
talk: バイト先のシフト減った	他を探してみてもいいかも
talk: コップを落としてしまった	新しいものを買おう
talk: 誰からもLINE来ない	私もだよ！
talk: すごく時間がかかってしまいました	紙とペンで整理してみよう！
talk: アルゴリズムが本当に難しい。	わかります。一つでも理解できれば上出来
talk: フォロワーにブロックされた	あなたとは相性が合わなかっただけ
talk: スタバの新作高すぎ	幸せの代金
talk: あと残り3回と知って焦っています。	3回もあるよ？ポジティブにいこう
talk: 重い仕事を任せられる	君ならできる
talk: 出席忘れた	まだ落単じゃないよ！
talk: お風呂の栓外れてた	それめっちゃショックなやつ…
talk: 物騒で電車に乗りたくない	だね、スマホに見入ったり、寝たりしないようにしてい気をつけよう！
talk: 財布落とした	クレカ止めて！
talk: トイレが混雑していた	女子はねぇ…
talk: 周りに早い友人が多くて焦ります。	追いつけるように頑張ってみよう！
talk: 全然遅れが巻き返せないです。	友だちと勉強会を企画しよう
talk: 録画してない	親に連絡しよ
talk: 現金忘れた	キャッシュレス還元率高いよ
talk: 第2回目の講義は進みませんでした。	来週までにもう一度チャレンジしてみよう！
talk: Gだ	逃げるぞ
talk: ヘアアイロン持ってき忘れた	イメチェンできるね
talk: チケット取れなかった	次とれるよ
talk: チケット売り切れてた	ライヴビューイングや配信を待とう。
talk: 問題を解くスピードがかなり遅いのですが大丈夫でしょうか。	ゆっくりやってこ
talk: 最初は感覚や文法が思い出せずに苦戦した。	だんだん感覚が戻ってきますよ、頑張って！
talk: 勉強にがて	自分が手を出せそうに思ったところからとりあえずやってみよう
talk: 自分のするべきことがわからない	出来ることから始めよう
talk: バイト長引いた	給料日の自分が喜ぶ！
talk: リストの範囲が難しく感じた。	リストは苦手な人が多い範囲です、丁寧に学習を進めよう！
talk: 猫の手借りたい…	ฅ^•·̫•^ฅ貸そうか？
talk: 勉強がうまくいかない	誰かと一緒にやろう
talk: 準備大変	大変な思いはいつか報われるよ
talk: 充電し忘れた	短期集中できるね
talk: 骨折した	お大事に
talk: ゴキブリが出た	怖すぎ
talk: 友達欲しい	もう友達じゃん
talk: 講義動画見忘れた	1回くらいなら大丈夫だよ
talk: 先週はあまりやる気が出ず解いた量も少なかったので進んでいる人との差が開いてしまったように感じました。	みんなそんな週もあるのできっとプラマイ0
talk: 天気悪くて洗濯物がたまる	コインランドリーいいよ
talk: 実際にやってみても難しくて鬱になりそうです。	関数のせいで鬱にならないで
talk: お金が少し足りない	お金が浮いたよ！
talk: 吊り革触りたくない	椅子確保！
talk: 炎上した	そうゆう時もある
talk: にわか雨にあった	風邪ひかないようにね
talk: 家計簿の計算合わない	おかしいな
talk: お気に入りの服が汚れちゃった	何とかしてきれいにできないかな…
talk: チケット外れた	きっと次は当たるよ
talk: 買い物で一個買い忘れた	家にあるもので試行錯誤してみよう
talk: 外出禁止になった	ステイホームを楽しもう
talk: 友達が冷たい	それはつらいね
talk: 試験に落ちた	次頑張ればいいよ！
talk: 電車に乗り間違えた	新しい旅の始まり！
talk: 宿題忘れた	たまには休憩も必要だよ
talk: もうだんだん追いつけてません。	自分で無理のない目標を決めるといいかもね！
talk: 映えない	映えてる
talk: ツリー飾るの面倒だな	飾った後の感動は頑張った人にしか味わえないよ
talk: 叩かれた	暴力反対！
talk: 蜂に追いかけられた	考えたくない
talk: どんどん内容が難しくなっていてまた課題の正解数がとても少ないので焦っています。	焦らず正解数を増やしていこう！とりあえず目標を決めてみよう！
talk: お金がたまらない	バイトを増やそう
talk: また期末が来てしまうので今のうちに頑張らなくてはならないな。	終わりは必ずきます
talk: 初めの方は比較的スムーズに解き進めていましたが電源プラグなどで時間を取られてしまいました。	こまめな充電大事
talk: センターが変わっちゃった	次のセンター誰だろうね
talk: 肩こりひどい	大丈夫？ゆっくり休んで
talk: ログインし忘れた	忘れちゃうこともあるよね
talk: 常に眠い	寝な
talk: オンラインだと質問しづらいです。	コギーに質問しなよ！
talk: 問題をやって心折れました。	だんだん慣れていこう！
talk: 人前に立つ仕事がある	頑張って
talk: 優柔不断	決めるの難しいよね
talk: 転んだ	大丈夫？怪我はない？
talk: ひったくりにあった	荷物はそのうち戻ってくるよ
talk: 欲しいものを買えなかった	他の店に買いに行こう！
talk: 鍵しめ忘れた	早めに帰ろう
talk: ご飯が冷たい	１０階にレンジあるよ
talk: アルゴリズムに入ってから問題が難しくなり腰が重たくなってきた。	みんな腰重くなりがち
talk: 少し難しくなってきた。	たぶん気のせいだよ！！
talk: 時間を見つけて楽しく解いてはいますが目標のACの数に届くか心配になってきた。	楽しく解けてるならいいじゃん！
talk: 連絡先きくの忘れた	運命の人だったかもね
talk: まだなんとかなると信じてます...ちょっとした打ち間違えや問題の読み取りミスが多くて参りました。	何とかなります、一日10問くらい？？
talk: 辛すぎる	いけるて
talk: カギ閉めたっけ	家戻る？
talk: テスト大丈夫かな	正直不安を感じている時点で大丈夫
talk: AtCoderを始めてからPythonの理解度が上がった気がします!	それは素晴らしい！目指せ色付きコーダー！
talk: 全くついていけないです。	週に1問でもいいのでとにかく解こう！
talk: 今週はあまりできませんでした。	明日から頑張ろう
talk: ユーザ名が明らかに自分すぎて演習問題の進み具合がバレるかもと思い失敗したなと思いました。	頑張っている感をアピールしてこ
talk: 靴擦れした	カットバン派？絆創膏派？
talk: 赤信号ばっかり！	そんな日もある！
talk: 寝不足だ	眠いよね
talk: 明日起きれるかな	早く寝よう
talk: 1時間くらい格闘しましたが負けました。悔しいです！	明日になったら勝てるかも
talk: テストでケアレスミスをした	しょうがないよ
talk: 電気をつけっぱなしにした	次気をつければいいんだよ
talk: 試験勉強を少ししかしなかった	後悔先に立たず
talk: モヤモヤする	大声で歌ってストレス発散だ！
talk: アウター欲しいけど高くて買えない	お年玉まで待とう
talk: オンラインだと質問しづらい。	コギーに質問しなよ！
talk: しょっちゅう忘れ物する	気を付けよう
talk: でもできないので今は嫌いです。	プログラミング経験があるとないとでは全然違うので、すぐにできなくても良いので練習を続けていこう！
talk: 鳥のフンがかかった	マジ萎えるよねぇ
talk: 好きな人がナルシストだった	それは萎えるね
talk: やりたくない仕事を続けている	頑張っているね
talk: 一問解くのに時間がかかりすぎてすでにお先真っ暗です。	最初はそんなものです、
talk: 彼氏が元カノと仲良い	可愛く拗ねよう！
talk: 一生彼氏ができない	そんな訳ない
talk: 頭痛が痛い	頭痛が痛いってっ！あんた…
talk: 近所の人に見られてる気がする	話してみたいと思われてるのかもしれない
talk: 他にもこんな人がいるのか気になります。	たぶんみんなそんなものです
talk: お金を使い過ぎた	稼げ稼げ
talk: チケットの販売期間終わっていた	これからきちんとチェックして忘れないようにすればOK!
talk: チケット忘れた	係の人に正直に話そう
talk: 初めて高速道路で運転する	安全運転！
talk: ゴキブリに遭遇した	ゴキジェットで頑張って!
talk: 難しくほとんどすすめることができません。	友だちと一緒に進めてみたらどうでしょう？
talk: 思っていたよりも2年の知識を忘れてい。	少し間があくと忘れてしまうよね、演習問題の最初から順にやって段々と思い出していこう！
talk: 個人情報がバレた	やばいな
talk: お金がない	節約力上がるね
talk: ブレイクアウトルームも友人が一人もおらずちきって入れませんでした。	大体飛び込んでみればなんとかなるので大丈夫だよ
talk: 就活しなきゃ	ゆっくりやっていこう
talk: バズった	最高！
talk: 道がわからなくなった	ググって
talk: 足がつった	痛いよね
talk: 大事なものをなくした	探し物は探すのをやめたときにみつかるよ
talk: 最近物騒で電車に乗りたくない	だね、スマホに見入ったり、寝たりしないようにしてい気をつけよう！
talk: 家の鍵をなくした	あれま
talk: 目標は100問ですがこれからもっと難しくなるだろうし目標を達成できるか心配です。	努力を続けることが大切です！
talk: 冷え性だ	暖かい恰好で過ごそう
talk: 進学どうしよう	先輩や先生に相談しよう
talk: 全然進んでない。	就活にも役立つし、やっておいて損はしない！
talk: 卒業ラッシュで悲しい	本人が決めたことを尊重しよう。
talk: 紙で切ってしまった	地味に痛い
talk: 友達に1問助けてもらいました!	友だち優しい、教える側も勉強になるのでどんどんヘルプを求めよう！
talk: SNSをやめたい	私もSNSはやっていない
talk: 完結した	２週目見るか
talk: お気に入りの服汚した	洗濯すれば落ちるかも
talk: もっと成績をよくしたい	もっと勉強しよう
talk: 友達との待ち合わせに遅刻した	すぐ謝ろう!
talk: 推しが炎上した	あー、それはドンマイ
talk: defを使うやり方を去年授業で確認してたはずなのですがあまり理解出来ていなかったらしく進みが遅くなりそうです。	defという単語を覚えているだけでも十分です、色々な問題で使ってあげてね
talk: 今日も寝る時間が遅くなった	毎日努力してて偉いね
talk: フードコートで席があいてない	相席でもいい？
talk: 財布無くした	クレカ止めて！
talk: パンクした	修理修理ー
talk: やる気が起きない	一緒にやろう
talk: 周りの音がうるさい	イヤホンで好きな音楽を聴いてみよう
talk: 今後が心配です。	基本をマスターしておけば大丈夫です！
talk: 友達にひどいことを言ってしまった	素直に謝ってみよう
talk: 好きな人に恋人できた	あの人イマイチだったよ！他にいい人いるよ！
talk: 自転車盗まれた	最悪じゃん
talk: 対応が悪い店員がいた	別のお店に行こう
talk: 白いコーヒーこぼした	ショック！
talk: 今日の内容は途中で詰まってしまったため進みません。	先の問題はもしかしたら解けるかも？
talk: 説明会に出忘れた	人生何とかなるさ！説明会に取り組んでいる君は頑張っている！
talk: 自分の好みが変わった	そうゆう時もあるよね
talk: 目疲れた	一旦、休もっか
talk: 次第に数学的にも難しい内容になってきているので難しいです。	ついでに数学マスターも目指しちゃう？
talk: 人の投稿羨ましい	人は人自分は自分
talk: AtCoderにまだ慣れない。	お付き合いはまだまだ続くので、ぜひ慣れてください
talk: その週ごとに進めていけばいいと思っていましたが友人はかなり進んでいたので不安です。	友達にたくさん頼ってみよう！
talk: 紙で指を切ってしまった	地味に痛い
talk: 落選した	オンラインでみよう！
talk: 教わってようやく1問という感じです。	まずその1問を正しく理解しよう！
talk: お隣さんとうまく話せない	練習していこう
talk: 頑張ろうと思っていたのですが「無理では...」と思えてきた。	気のせい気のせい
talk: 見やすいように名前を入れたのですがどこがダメなのかよくわからないです。	落ち着いて考えてみよう
talk: 難しくほとんど進めることができませんでした。	友だちと一緒に進めてみたらどうでしょう？
talk: お財布忘れた	愉快なサザエさん♪
talk: 関数が苦手なので理解するのが難しい。	演習課題で慣れていこう！
talk: 家に強盗犯が入ってくるかもしれない	宝くじに当たるくらいの確率だから、多分入ってこないと思うよ!
talk: 辛い	お互いがんばろう！
talk: 周りに比べたらまだまだ進捗は遅いかもしれません。	まぁいいじゃん、マイペースで進めていこ
talk: 既読無視された	いそがしいんだよ、きっと
talk: お店閉まってる	そんな時もあるよ
talk: 課題の提出時間に間に合わなかった	次から遅れないようにすれば大丈夫だよ!
talk: 宿題が終わらない	できるところまでやろう
talk: 友達来ない	きっと来るよ!
talk: 友達が増えない	きっとこれからできるよ
talk: あと一つです。	あと少し！頑張って！！
talk: 人の名前を忘れた	仕方ない
talk: 服汚した	洗ってきな
talk: 友達冷たい	それはつらいね
talk: 最近彼氏が冷たい	それはつらいね
talk: 明日起きれるか不安	早く寝よう
talk: 次第に数学的にも難しい内容になってきている。	ついでに数学マスターも目指しちゃう？
talk: AtCoderの方は最近進みが悪くなりました!!難しくなってきました、	難しくなっているから仕方ない！頻度を落とさなければ問題ないです！
talk: 休講で特にやっていないため何も進んでいません。	休講日は遊ぶべき
talk: 毎回割と苦労してます、。	今苦労しておけば、来年は楽になれますよ！
talk: 関数難しいです。	引数と返り値を意識するといいかも！
talk: 面接官が怖かった	どんな感じ？
talk: 単位ください!	コギーにはどうにもできません
talk: 親友に仲の良い友達が出来た	気にしすぎちゃダメ
talk: ドラマ見逃した	見逃し配信をチェック！
talk: 急に雨が降ってきた	雨宿りしよう
talk: スマホの充電が切れた	勉強に集中できるね
talk: 仕事でミスをした	次気をつけよう
talk: 提出出来なかった	それは、ちゃんと確認しよ
talk: 推しが引退した	それは無理
talk: 人の投稿が羨ましい	人は人自分は自分
talk: ワクチン怖い	いや？意外とそんなことないよ
talk: スマホを無くした	えっ？！やばいやん・・・
talk: 取り敢えず悲しい	気分をあげに行こう！
talk: 勉強	今が頑張りどきやで！頑張れば結果がついてくる。
talk: 今日であれば友達は3回目の授業内容から進めるので聞きづらいです。	授業時間外に聞いてみるのも良いかもね
talk: 承認してくれなかった	間違えて削除しちゃったんだよ
talk: 寝なきゃいけないのに寝れない	ホットミルク飲むと良いよー
talk: 他大学の人たちと予定合わない	みんな忙しいから仕方ないよね…
talk: 虫歯ができた	いよいよ歯医者に行く時だ
talk: 予定をドタキャンされた	今度全額奢ってもらおう
talk: 推しがSNSで叩かれた	推しが素敵だから嫉妬してるんだよ
talk: テストの結果が悪かった	そういう時もあるよ!次、頑張ろう!
talk: AtCorderが少し難しい。	だんだんできるようになってくるから大丈夫！
talk: 私は繰り返し文が苦手だったのでfor文やwhile文の違いがよくわかっていませんでした。	いませんでしたってことはわかるようになったってことだね！優秀！
talk: 足踏まれた	なんそいつ
talk: 親が干渉してくる	自分の意見を言った方がいい
talk: 皆さん早く出来ているのかと思うと心配です。	みんなも時間がかかりすぎてしまうって言っているよ！大丈夫！
talk: ゲームのログイン忘れた	それめっちゃ悔しいよね
talk: マイペース	のんきなのは心の余裕があるからよ
talk: 〆切が迫ってる	あと少し、頑張って！
talk: コンサートの抽選に落ちた	そっか…次当たるよきっと！
talk: 何回も不正解が出てしまい心が折れそうになりました	そんな時は一回飛ばしちゃお
talk: 急に難しくなってきて全然理解できなくて落ち込みました。	落ち込まないで！落ち着いて考えてみよう！
talk: 周りとなじめない	何色にも染まらないなんて素敵
talk: 周りの人が進んでいると思うと焦ってしまいます。	たぶん同じくらいの人もたくさんいるよ！焦らずコツコツやりましょう
talk: ボールペンを忘れた	貸すよ
talk: ずっと見てしまう	スクリーンタイム機能を使おう
talk: 関数を使い慣れていないので難しかった。	今まで習った構文とは少し書き方が違うので難しいよね、だんだん慣れていこう！
talk: 欲しかったものがお店に行ったら売り切れていた	きっとそれよりいいものが買えるよ!
talk: 最近自分一人で解ける問題が全然なくて焦っています。	焦る必要はないし、全てが自力である必要もないです！少しずつで大丈夫です
talk: REが何回か出てしまって困りました。	ちょっと休憩してからもう一度確認してみよう！
talk: 将来がみえない	まだいろんな道を選べるよ
talk: バナナですべった	そんなバナナ🍌
talk: お気に入りの服汚れちゃった	何とかしてきれいにできないかな…
talk: 耳痛い	イヤホンのしすぎかも？
talk: 写真写りが悪い	わかる!、ちょっと後ろに立って写ってみたら？
talk: 頭が痛い	パソコンの見過ぎなんじゃない？
talk: カップルの惚気多すぎる	ほほえましいね
talk: 前よりも授業内に進むスピードが遅くなっていると感じます。	じゃあ二倍速くらいにしてもらいますか
talk: 思った以上にプログラミングのことを忘れていて少し苦労しました。	少しやらないとすぐ忘れちゃうよね、わかる。定期的に練習できると良いね！
talk: リモコンない	探そう
talk: 筆箱忘れた	ペン貸そうか？
talk: プログラミングが正直得意な方ではありません。	習得したいというモチベの方が大切です！
talk: 遊びに行けない	お金貯めて収まったら遊びに行こう！
talk: 実験実習費の納入間に合わなかった	締め切り過ぎてても大丈夫だよ
talk: 先週と今週の講義はとても難しくてまだしっかりと理解できません...。	こまめな復習や演習をお忘れなく！
talk: 泣きたい	存分に泣けばいい。
talk: 週に解くスピードもやる気も落ちてきてしまっているのが最近の悩みです。	週に10問解けたら褒めてあげるよ？
talk: REやWAが来るとへこみます。	そんな時はコギーが相手になるよ
talk: わからない問題はどんどん飛ばしていってしまっているので不安です。	少したったらもう一度トライしてみよう！
talk: なかなか答えにたどり着けなくなってきて悔しい。	悔しさをバネにして、ぜひ答えを見つけてください
talk: 彼氏の返信が遅い	いそがしいんだよ、きっと
talk: 断れない	嫌ならはっきり断りな！
talk: アルゴリズムに入ってから授業内容に追いつけていない。	授業外の時間で復習してみよう！
talk: 彼氏に振られた	もっといい人いるよ
talk: メンタルがやられそうです。	プログラミングでメンタルやられないで、相談乗るよ
talk: 遠くの人の足元まで消しゴムが転がった	後で取りに行こう…
talk: 部屋番号を間違えた	あら、ドジっ子ちゃん〜
talk: 砂糖と塩を間違えた	味が気になる…
talk: 物忘れがひどい	たくさんのことをかんがえてるんだね
talk: 宣告された	余命宣告されてない人だっていつ死ぬかわからんから悔いのないように生きよ！
talk: 困った	問題解決は原因を分析することが一番やで！よく考えて次に行動しよう。
talk: 反応が来ない	いつか来るよ
talk: リストが苦手で今週の講義は自分には難しい。	目指せリストマスター
talk: お金少し足りない	お金が浮いたよ！
talk: 犬に噛まれた	お大事に
talk: 誕生日プレゼント買い忘れた	気が付くことが大切
talk: 家の鍵忘れた	よくあるね
talk: 今日はパソコンの調子がおかしく全然進みませんでした。	明日になったら機嫌良くなるかも！
talk: ペットが死んだ	悲しいね、、、
talk: 風邪ひいた	お大事に
talk: ガチャガチャで同じのが3回も出た	メルカリで売れるよ！
talk: 方程式を立てて変形するのに時間がかかってしまいました。	方程式を立てるだけでも優秀すぎます
talk: シフト急遽入った	その分稼げるよ
talk: 集合時間が早すぎ	早起きは三文の徳
talk: フォロワー増えない	徐々にがんばろ
talk: 遊びたい	やることやって遊んだらええ。
talk: ナルシスト	一番冷めるやつやん！
talk: ブレイクアウトルームも友人が一人もおらずちきって入れません。	大体飛び込んでみればなんとかなるので大丈夫だよ
talk: 人前に立つ仕事ある	頑張って
talk: 提出物だし忘れた	提出物忘れ一回？余裕だね！
talk: 親に怒られた	嫌だね
talk: 私服で会場に行ったら皆スーツだった	笑笑
talk: ゴミ箱をひっくり返した	だるいね
talk: 友達が待ち合わせに遅れた	遅れてくるのは良くないよね
talk: めっちゃフォロワー減った	ただみんながインスタ辞めただけじゃない？
talk: 推しが打たれた	そういうときもあるさ
talk: プログラミングがどうこう以前に数学力が試された。	数学力はいる時もあればいらない時もあるよ
talk: 冷蔵庫のプリン食べられた	また買ってこよう
talk: プレゼントをもらった	最高の友達だね
talk: 解ける問題がだんだんなくなってきていて焦っています。	焦る必要はないです！自分で問題を探してみてもいいかもね
talk: パソコンのデータ全部消えた	次からバックアップを取るようにすればOK
talk: アルゴリズムについての内容に入り難しいな、、と感じています。	アルゴリズムの知識をまず勉強していきましょう
talk: c問題が増えてきて難しくなってきた。	C問題の壁は大きいですが、この調子で！
talk: ノンスタ井上	(-_-;)
talk: 先週先々週に引き続き全然進んでなくてより腰が重くなっています。	腰を粉砕してあげよう
talk: 読んでた漫画が終了した	作者の次回作を待ちましょう
talk: 自分のせいで試合に負けてしまったんじゃないか	そんなことないよ
talk: 先生をお母さんって呼んじゃった	小学生みたいだね
talk: テスト忘れてた	何とかなるさ
talk: お店が定休日だった	他のお店探してみよう
talk: 推しの投稿頻度が少ない	今忙しいんだよ！きっと
talk: 人目線	他人を気にして行動する人生でいいんすか？
talk: 振り込み忘れてた	まだ間に合うよ
talk: 内定もらえない	そんじゃ、私と開業しない？（笑）
talk: 仮眠しようとしたら4時間寝てた	次の日頑張れば大丈夫
talk: 遊ぶ予定がなくなった	また今度会えるよ
talk: 電車止まって帰れない	予定狂うね
talk: 今日雨降るかなあ？	一応傘持ってた方がいいんじゃない？
talk: 大勢の人の前で転んだ	大丈夫！？記憶は薄れるだろうし気にしない気にしない！
talk: 相手の名前を忘れてしまった	よくあるよね
talk: 今日の関数はとても難しい。	難しいと感じている人はあなただけじゃないよ
talk: 一人では全く進められなくなってきて焦っています。	焦らなくても大丈夫、少しずつ進めていこう！
talk: 思ったことを気軽につぶやけないときがある	その方がいいよ！口は災い元だから！
talk: 予定すっぽかした	後で謝ろう
talk: 浮気された	し返せ
talk: 授業ノートをなくして勉強ができない	私のでよければ貸すからそんなに落ち込まないで!
talk: 推しのキャラクターグッズをたくさん買ってしまう	わかる！
talk: 画面を見すぎて目疲れた	一旦、休もっか
talk: お風呂入りたくない	うちも入ってない、朝までに入ればオッケー
talk: 倉光先生は優しいので出席していれば\単位は取れるだろう	コギーもそうだと思う
